喜欢 打篮球 的 男生 喜欢 什么样 的 女生	爱 打篮球 的 男生 喜欢 什么样 的 女生	爱情 里 没有 谁 对 谁错 吗 ？
我 手机 丢 了 ， 我 想 换 个 手机	我 想 买 个 新手机 ， 求 推荐	剑灵 高级 衣料 怎么 得
大家 觉得 她 好看 吗	大家 觉得 跑 男 好看 吗 ？	照片 怎么 变成 漫画
求 秋色 之 空 漫画 全集	求 秋色 之 空 全集 漫画	带 避孕套 会 怀孕 吗
晚上 睡觉 带 着 耳机 听 音乐 有 什么 害处 吗 ？	孕妇 可以 戴 耳机 听 音乐 吗 ?	是 的 ， 如果 您 的 产品 没有 到期 的话 是 需要 收取 手续费 的
学 日语 软件 手机 上 的	手机 学 日语 的 软件	圆柱 、 圆锥 、 球 的 共同点 是 什么 ？
打印机 和 电脑 怎样 连接 ， 该 如何 设置	如何 把 带 无线 的 电脑 连接 到 打印机 上	春天 这个 季节 用 什么 洗发水 比较 好 ？
侠盗 飞车 罪恶都市 怎样 改 车	侠盗 飞车 罪恶都市 怎么 改 车	学而不厌 的 下 一句 子 。
什么 花 一年四季 都 开	什么 花 一年四季 都 是 开 的	天天 酷 跑 怎么样 开 挂
看 图 猜 一 电影 名	看 图 猜 电影 ！	这个 女 的 叫 什么 韩国 的 网络红人
这 上面 写 的 是 什么 ？	胃 上面 是 什么	有没有 好看 的 韩国 电影
建议您 重新 注册 ， 辛苦 您 了 。	可以 的 ， 您 注销 成功 后 ， 可以 重新 注册 的 ， 辛苦 您 了 。	用 一会儿 ， 一会儿 造句
小草 有 什么 的 特点 , 可以 象征 什么 ?	小草 有 什么 特点 可以 象征 什么	甲 是 乙 的 粉丝 ， 是 什么 意思
校验 失败 了 ，	您好 ， 您 还是 访客 状态 呢	黄海波 和 高圆圆 什么 关系
尼玛 什么 意思	尼玛 啊 是 什么 意思 ？	现在 流行 什么 手机 铃声
自找苦吃 的 地方 是 哪儿 ？	自找苦吃 的 地方 是 哪儿	四个 字 好听 的 名字
尾号 4 位 多少	尾号 是 多少 后 4 位	过年 去 成都 有 什么 好玩 的 ， 好吃 的
谢文东 能 在 哪里 看	谢文东 在 哪里 看	在家 怎么 赚钱 ？
新 概念 英语 第二册 练习册 41 课 答案	新 概念 英语 第二册 练习册 21 练习 答案	得 了 痔疮 还 可以 怀孕 吗 ？
过年 送礼 送 什么 好	过年 前 什么 时候 送礼 ？	什么 牌子 的 创可贴 好
壮丁 是 什么 生肖	欲 钱 买 壮丁 指 的 是 什么 生肖 ？	微 博 怎么 刷 话题
这 是 什么 蔬菜 啊	这 是 什么 蔬菜 呀 ？	上 了 女朋友 的 朋友
最近 有 什么 好 电视剧 看 ？	现在 看 电影 都 是 有 哪些 号 网站 啊	北极熊 为什么 不吃 企鹅 宝宝 ？
性与爱 有 什么 区别 ？	性与爱 有 什么 区别	手机 看 电影 用 什么 播放器 好
网上 卖 的 烟 有 真的 吗 ？	网上 帮 你 刷 钻 是 真的 吗	我 是 歌手 里 李 健 用 的 那个 健身器材
什么 印象	什么 印象 了	淘宝 现在 做 什么 好
面相 上 看 ， 耳垂 上 有 痣 代表 什么 ？	男性 耳朵 上 长 痣 代表 什么 （ 耳垂 这里 ）	这个 是 海贼王 中 第几 集 ？
男生 喜欢 女生 送 他 什么 礼物 呢	男生 最 喜欢 女生 送 什么 礼物	什么样 的 女人 才 是 男人 满意 的 标准
如何 快速 忘记 一个 人	怎样 能 快速 忘记 一个 人	很 抱歉 . 您 的 这个 情况 小 二 只能 给 您 这个 建议 . 给 您 添麻烦 了 .
周杰伦 女友 是 谁	周杰伦 的 现 女友 是 谁	求 这 张 图 的 动漫 ！
月初 和 月末 是 会 出现 这个 延迟 的 情况 的 ， 小 二 建议您 耐心 等待 一下	因 周六 周日 不 属于 工作日 所以 建议您 耐心 等待	推荐 好 电影
支付宝 手机 支付 密码 是 什么	支付宝 里 手机 支付 密码 是 什么	家里 来 了 一只 狗 好不好
关于 网页 设计 的 问题	关于 网页 设计 的 一个 问题	红 格子 裤子 配 什么 颜色 衣服 好看
有没有 专门 为 房地产 行业 做 咨询 的 公司 啊 ？	国内 咨询 公司 中 哪家 的 房地产 咨询 做 的 比较 好 啊 ？	求 这 张 权 志 龙 的 原图 ！ 急 ！
这 系列 的 漫画 叫 什么 名字	这个 系列 的 漫画 叫 什么 名字 ？	中国 大 历史 全集 - 黄仁宇 . txt
无线 路由器 怎么 无线 上网	无线 上网卡 和 无线 路由器 怎么 用	转运 公司 哪家 好
左 眼皮跳 是 什么 原因	女 的 右 眼皮跳 是 什么 原因 啊 ？	为什么 宫 洺 换人 了
部落 战争 怎么 更新 ？	部落 战争 ， 怎样 更新	非常 抱歉 亲 ， 您 已经 实名 效验 了 ， 是 不能 修改 认证 的 信息 的
这个 空气 净化器 有用吗 ？	空气 刘海 是 怎么样 的	有没有 超 拽 的 个性 签名 啊
看 图 猜 成语 ， 这 是 什么 ？	【 看 图 猜 成语 】 请问 这个 是 ？	这 是 什么 字 ？ 怎样 组词 ？
找 工作 网站 哪个 好 ？	找 工作 哪个 网站 好	时空 猎人 里 的 龙 灵 怎么 觉醒 ？
问 发型 ， 男生 。	关于 男生 发型	请 输入 港澳 证件 的 后 4 位 （ 是 证件 上 的 身份证号 ）
安 卓 手机 怎么 设置 来电 自动 接听	三星 手机 怎么 自动 接听	请问 有 不 收费 的 婚恋 网站 吗
部落 冲突 游戏 怎么 找回	部落 冲突 重置 游戏	笨拙 的 反义词 是 什么 ?
怎么 才能 下载 穿越 火线	穿越 火线 的 挂 怎么 下载	那种 色 的 小说
你 点击 详情	您 点击 详情	爱情 保证书 怎么 写 ？
我 要 找 一个 人 怎么 找	我 要 找 一个 人	如何 快速 瘦 脸
中国 四大 古城 是 哪些 ？	中国 的 四大 古城 有 哪些 ? 5	新年快乐 ， 亲
脸上 痣 太 多 怎么办 ？	脸上 痣 太 多 怎么办	夜晚 ， 一 闪 一 闪 的 星星 - 撒满 天空
福州 哪家 装修 公司 好	转运 公司 哪家 好	男 的 ， 短发 能 做 什么 发型 呢 ？
请问 下 这 是 什么 表情	请问 这个 表情 叫 什么 ？	怎么 报复 背叛 自己 的 男友
大限 什么 意思	微 淘 什么 意思	你 也 和 你 儿子 发生 关系 ？
名人 理财 小 故事 几则	投资 理财 的 小 故事	投资 亚洲 艺术 公园 好 吗 ？
奔跑 吧 兄弟 里 的	奔跑 吧 兄弟 主题曲 ！	为什么 我 的 手机 支付宝 没有 蚂蚁 花 呗
宝盖头 的 字 与 什么 有关	河水 像 什么 有关 的 字	这 是 什么 石头 值钱 吗 ?
下雪 了 ， 房子 像 什么 ？	下雪 了 ， 房子 像 什么	什么 花 一年四季 都 是 开 的
一本 官场 小说 的 名字 ？	我 想 找 一本 小说 名字 叫 什么 骨	四川 商务 职业 学院 好不好 呀
求 恋爱 棱镜 漫画	求 恋爱 棱镜 的 漫画 。	我 不会 唱歌 怎么办
类似 于 植物 大战 僵尸 的 游戏 有 哪些	有 哪些 游戏 和 植物 大战 僵尸 类似	暴风 影音 怎样 看 黄 ？
这 是 什么 动画 啊	这 是 什么 动画 ， 叫 什么	百度 钱包 怎么样
日本 爱情 吻 戏 动漫	哪部 韩剧 吻 戏 最 多	东张西望 的 张 是 什么 意思
哪位 亲 有 东方 神 起 塞班岛 的 写真 辑 啊 ？	这 张 图 是 东方 神 起 在 哪里 的 写真	桃花 眼 还是 杏眼
石家庄 天气 如何 ？	石家庄 天气 怎样	苹果 五 原装 耳机 多少 钱
中国 哪里 的 地方 最美	中国 最 美丽 的 地方 再 那里	请问 下 这个 狗 是 什么 品种 ？
追女孩 该 怎么 追 ？	追女孩 要 怎么 追	骆宾王 《 咏 鹅 》 ：
高中数学 问题 ， 数列	高中数学 ， 数列 问题 。	什么 叫 偶数 什么 叫 奇数
劝告 你 不 听 是 什么 成语	只要 不 听 劝告 是 什么 成语 带 一 的	早上 空腹 喝水 有 什么 好处
支付宝 为什么 不能 实名 认证	为什么 不能 支付宝 实名 认证 ？	东方 神 起 哈哈 颂
小尾巴 怎么 设置	贴 吧 里 的 小尾巴 怎么 设置 ？	灌肠 器 怎么 用
麻烦 您 点击 链接 看看 的 ， 辛苦 您 了 。	您 点击 账户 通 - 我 的 银行卡 - 添加 就 可以 的 ， 辛苦 您 了 。	现在 开 淘宝 店 ， 还 挣钱 吗
罗 志 祥 的 发型 叫 什么	罗 志 祥 的 发型 叫 什么 ？	本事 的 近义词
红豆 薏米 粥 减肥 靠 谱 吗	红豆 薏米 粥 能 减肥 吗	对方 账户 是 已经 激活 的 正常 使用 的 账户 的 ， 资金 已经 交易 成功 ， 从 您 账户 支付 的
大写 的 万 字 ， 怎么 写 ？	大写 万 字 怎么 写 ？	有 什么 好玩 的 手机 安 卓 单机游戏
网易 新闻 和 腾讯 新闻 哪个 强	腾讯 新闻 和 网易 新闻 哪个 好	支付宝 账号 在 哪里 看
这边 给 您 发送 ， 您 从 新 操作 一下 可以 吗 ？	您好 ， 您 的 这个 红包 是 只能 在 这个 给 您 发送 红包 的 商家 使用 的 ， 麻烦 了 。	因为 电脑 上面 有 【 通过 人工 服务 】 找回 方式 ， 手机 上面 没有
游戏王 混沌 力量 城 之内 篇 全 卡 下载	游戏王 之 混沌 力量 - 城 之内 篇 汉化版	今年 端午节 怎么 放假
苹果 手机 怎么 截图 啊	苹果 手机 怎么 截图 ？	下雪 了 ， 房子 像 什么
张 翰 和 郑 爽 是 为什么 分手 ？ ！ ﹏	张 翰 和 郑 爽 为什么 分手	硫酸铜 溶液 和 氢氧化铜 溶液 的 颜色 都 是 绿色 吗 ？
上海 哪里 有 卖 纹身	上海 哪里 洗 纹身 好	这 是 什么 花 ？ 名字 ， 怎么 养 ？
你们 心目 中 的 女神 什么样 ？	你们 心目 中 的 女神 是 怎样 的 ？	请 您 到 时 以 页面 的 显示 为准 的
头发 干燥 怎么办 ？ 发 质 很 差 。	发 质 差 怎么办 ， 而且 很 毛躁 ？	时空 猎人 多 酷 版 在 哪 下载
月经期 可以 喝 中药 吗	酸奶 加 红糖 怎么 喝 才能 减肥	手机 跑 分 是 什么 意思 啊 ？
喝 绿茶 有 什么 好处 ！	喝 绿茶 有 什么 好处 ？	奥特曼 和 超人 谁 厉害
微 信 公众 平台 怎么 盈利 ？	微 信 公众 平台 如何 盈利 ？	老人 祝寿 送 什么 好 ？
描写 水 的 四 字 词语	含 反义词 的 四 字 词语	有 什么 好看 的 电视剧 ， 推荐 一下
淘宝 的 拍卖 保证金	淘宝 拍卖 保证金	女人 下面 是 什么 样子 的
求 《 天空 之 城 》 吉他谱 ！ 六线谱 ， 简单 点	求 《 天空 之 城 》 原版 吉他谱	淘宝 店铺 装修 和 推广 怎么 做 啊
去 哪儿 网 特价机票 怎样 订	去 哪儿 特价机票	网上 帮 你 刷 钻 是 真的 吗
明天 上海 天气 怎么样	明天 上海 天气 怎么样 。	这 是 钱币 吗 ？ 是 哪个 国家 的 ？
湖北 生态 工程 职业 技术 学院 好不好 ？	湖北 生态 工程 职业 技术 学院 的 环境 怎么样 ？	这个 英文 字体 是 什么 ？
辛苦 您 把 页面 截图 一下 ， 谢谢 。	感谢您 的 耐心 等待 ， 麻烦 您 把 收银台 付款 页面 截图 提供 下 ， 辛苦 您 了 。	刘 烨 的 老婆 是 谁
手机 铃声 怎么 下载	手机 铃声 怎样 下载	亲 ， 您 是 说 余额 宝 的 吗 ？
如 没有 其他 的 问题 小 二 这边 就 不 打扰 您 了	好 的 ， 请问 需要 帮 您 一并 清空 安保 问题 的 吗 ？	怎样才能 去 斑 。
老 版本 的 天天 酷 跑 怎么 下载	怎样 下载 天天 酷 跑 老 版本	孕妇 草莓 能 吃 吗
怎样 可以 让 肚子 变小 ？	怎样 让 肚子 变小 ？	桃子 老师 与 四个 学生
蜡烛 的 英语单词 怎么 读音 标 是 什么	怎么 看 音标 把 英语单词 读出来 啊	第三个 字 是 爱 的 七个 字 歌名
您 说 下 时间 哦	排队 时间 在 1 分钟 足 有	南宁 有 什么 好玩 的 地方 ？
大陆 女明星 谁 最 漂亮 ？	大陆 女明星 谁 最 漂亮	怎么样 让 头发 快速 生长 ？
容易 的 易 还 可以 组 什么 词 ？	养 什么 鱼 不 容易 死 ？	求 三国 杀 虎牢关 音乐
时空 猎人 腾讯 版 怎么 刷 龙 影	时空 猎人 腾讯 版 怎么 刷 vip	这位 模特 叫 什么 名字
白猫 计划 怎么 退出 公会 ？	DNF 公会 升级 怎么 不 送 东西	孕妇 那些 东西 不能 吃 ？
现在 来说 什么 行业 最 挣钱 ？	现在 什么 行业 最 挣钱 ？	求 武汉 得意 网 邀请 码
黑人 生殖器 为什么 那么 长	黑人 的 生殖器 为什么 那么 长	老虎 狮子 谁 厉害
现在 做 淘宝 还 能 挣钱 吗	现在 开 淘宝 店 ， 还 挣钱 吗	淘宝 评价 怎么 修改
怎么 查 通话记录	怎么 查 别人 通话记录	时空 猎人 如何 找回 密码
梦见 抱 小女孩	梦见 抱 别人 小 小女孩	天地 癞子 斗地主 都 是 怎么 作弊 的 ?
小 青蛙 过河 怎么	小 青蛙 过河 怎样 过	怒之铁拳 怎么 玩
分式 的 运算 一	分式 的 运算 ！	如何 查找 手机 位置
我 老婆 偷人 了 我 该 怎么办	老婆 偷人 我 该 怎么办 ！	侠盗 飞车 怎么 开 飞机
芜湖 职业 技术 学院 和 安徽 财贸 职业 学院 哪个 好 ？	安徽 职业 技术 学院 和 安徽 财贸 职业 学院 哪个 好 ?	秋天 还有 那些 水果 呢
唐诗宋词 元曲 和 什么 的 ？	唐诗宋词 元曲 汉 什么	怎样 防止 衣服 缩水
头晕 胸闷 恶心 是 什么 病	头晕 胸闷 犯 恶心 是 什么 病	百度 财富 值 有 什么 用 啊 ?
自己 的 提问 怎么 删除	怎么 删除 自己 发 的 提问	淘宝 注册 手机 注册 ？ 邮箱 注册 ？
黑白 的 情侣 头像	情侣 头像 黑白 类	山东 青年 政治 学院 专科
您好 ， 邮件 会 通知 您 的 。 辛苦 您 等待 下	辛苦 您 等待 下 的 ， 辛苦 您 了 。	我 女朋友 突然 跟 我 分手
什么 牌子 的 小 米粉 好 ？	什么 牌子 的 米粉 好	怎样 撕 美女 衣服
男科 疾病 有 哪些 ？	世界遗产 有 哪些 ？	承诺 是 什么 意思 ？
怎样 保护 青蛙	保护 青蛙 怎么样	点钞机 哪个 牌子 好
朋友 过生日 唱 什么 歌	朋友 过生日 送 他 什么 歌	乔布斯 是 怎么 死 的 ？
山西 工商学院 怎么样	山西 工商学院 怎么样 ？	死亡 笔记 电影版 全集 下载
北京烤鸭 在 哪	关于 北京烤鸭	把 词语 补充 完整 。 ( ) 才 是 ( )
这个 人物 出自 哪部 动漫 ？	这个 人物 出自 哪部 动漫	为什么 回民 不吃 猪肉
微 信 表情 都 代表 什么 意思	微 信 表情 代表 什么 意思	有 什么 好看 的 电视
女孩子 叫 我 欧 巴 是 什么 意思	很 要 好 的 女生 叫 我 爸爸 … 这 是 什么 意思 ？	活 的 大龙虾 怎么 做 好吃
幸福 花园 的 全集 动漫 谁 有 呀	谁 有 幸福 花园 动漫 全集 ？	我们 身边 有 哪些 科学知识
微 信 听筒 模式 怎么 关	微 信 怎么 改 听筒 模式	关于 交通规则
最 果 て の 神 狐 的 种子 。	跪求 あ ず み 恋 迅雷 种子	怎样 用纸 折 花 蓝
老公 过生日 做 什么 菜 怎么样	男朋友 生日 做 什么 菜 好	怎么 去 和 美女 搭讪 ？
很 讨厌 一个 人	韩国 人 很 讨厌 日本 人 吗	今年 衣服 流行 什么 颜色
天上 的 小白羊 ， 指 的 是 什么 ？	天上 的 小白羊 ， 指 的 是 什么	为什么 我 的 胡 莱 三国 小分队 每次 登 入 都 得 重新 设置
你 表情 搞笑 吗 ？	找 一些 搞笑 的 表情	慢性 湿疹 吃 什么 药 ？
求 幸福 花园 全集 下载	求 幸福 花园 全集 下载 。 、	茄子 咸菜 如何 做
宝宝 喝 什么 奶粉 比较 好	给 宝宝 喝 什么 奶粉 比较 好 ？	求 冶金 工程 设备 采购 的 资料
“ 客观 ” “ 主观 ” 分别 是 什么 意思 ？	主观 与 客观 分别 是 什么 意思	广州 和谐 医院 怎么样 ？
你 喜欢 什么 星座 的	喜欢 什么 星座 男	蒸 米饭 什么 锅
这 是 什么 牌子 香水	这 是 哪个 牌子 的 香水	已知 答案 ， 求 过程
东莞 哪里 有 草莓 园	东莞 哪里 有 草莓 场 ？	我 为 您 创建 受理 单 修改 可以 吗 亲
思春 是 什么 意思 嘛	思春 是 什么 意思 ？	业已 的 业 是 什么 意思
什么 海鲜 好吃 ？	什么 海鲜 好吃 啊	醋 泡 香蕉 能 减肥 吗
秦始皇 是 哪个 朝代 的	秦始皇 是 哪个 朝代 的 ？	苹果 手机 微 信 分身 版 怎么 下载
什么 是 安徽 的 简称	安徽 简称 什么 ？	我 的 世界 手机 版 存档 怎么 用
陈 坤 和 赵 薇 怎么 了	陈 坤 赵 薇 怎么 了	江西 理工大学 应用科学 学院 是 二本 吗 ？
买 理财产品 有 风险 吗	买 理财 有 风险 吗	蔡依林 和 周杰伦 到底 什么 关系 ？
推荐 几个 下载 电影 的 网站	可 下载 的 电影 网站 推荐	请问 您 是 使用 什么 信息 注册 的 支付宝 账户 ？ 您 可以 提供 一下 报错 页面 的 截图 吗 ？
填 成语 看 图片	这个 图片 的 成语	这个 玛瑙 是 真的 吗 ？
紧 的 偏旁 是 什么	汞 是 由 汞 分子 组成 的 对 吗	三角形 的 性质
今天 七夕 你们 怎么 过 ？	今天 七夕 你们 怎么 过 的	请问 这位 女优 叫 什么 名字 ？
如何 做生意 赚钱 … ？ 啊	怎样 做生意 才 会 赚钱 呢	君子 是 什么 意思 ？
百度 上 的 财富 值 有 什么 用	百度 财富 值 有 什么 用 啊 ?	义乌 哪里 有 饰品 手工 活 拿 回家 做
谁 知道 这 图片 叫 什么 ？	谁 有 这个 图片 或者 知道 她 是 谁	为什么 脸上 会 突然 出现 一个个 的 小红点
怎么 用 手机 下载 日语 输入法	手机 日语 输入法 下载	身高 153 ， 可以 读 浙江 旅游 职业 学院 吗 ？
夏天 吃 什么 水果 可以 排毒	夏天 吃 什么 水果 能 起到 减肥 的 功效 呢	为什么 我 的 手机 不能 接 打电话 了
灰 太 狼 的 梦想 是 什么 呢	灰 太 狼 的 梦想 是 什么	苹果 要 那个 国家 出 的 好
做 会计 在 房地产 与 制造业 哪个 好 ？	在 外贸公司 做 会计 好 还是 房地产 作 会计 好 ？	求 一首 很 老 日本 歌曲
百度 一下 你 不 知道	百度 一下 你 就 知道 是 谁 说 的	燕麦 面 怎么 吃
我家 兔子 是不是 怀孕 了 ?	我家 兔子 怀孕 后 摸不到 胎儿	求 音乐 ： 马 林 巴 琴 铃声
是 的 呢 ， 请 您 以 页面 的 显示 为准 的	请 您 到 时 以 页面 的 显示 为准 的	什么 水果 是 最 好吃 的
是 已经 在 催 了	请 您 放心 ， 资金 已经 退回 给 您 了	兔子 怎样 交配 ？
我 的 减肥 方法 正确 吗 ？	谁能给 我 搭配 正确 的 减肥 方法	梦见 喜欢 自己 的 男生
电脑 重装系统 要 多少 钱 ？	手机 屏幕 破 了 ， 换 个 多少 钱 ， 贵 吗	广东话 ， 知 你 爱 啊 飘 啦 是 什么 意思
有 什么 电影 可以 介绍 吗	有 新 电影 介绍 吗	帮帮忙 ． 谢谢 ．
天天 酷 跑 怎么 刷 积分 ？	天天 酷 跑 怎样 刷 积分 ？	男性 耳朵 上 长 痣 代表 什么 （ 耳垂 这里 ）
马 叉 虫 是 什么 意思 ！	马 叉 虫 什么 意思 ！	怎么 改 银行卡 密码
葫芦 侠 怎么 使用	葫芦 侠 怎么 使用 ？	文房四宝 指 的 是 哪 四 宝 ？
求 音乐 ： 世界 不是 我们 的 家	求 音乐 ： 巴 啦 啦 歌曲	本命年 带 什么 好 ？
茶杯 犬 难 养 吗 ？ 买 一只 大约 多少 钱 ？	茶杯 犬 合肥 哪里 有 卖 的 ？ 多少 钱 一只 ？	您好 ， 因为 找回 密码 是 需要 您 提供 资金 凭证 的 ， 如果 无法 提供 是 无法 找回 密码 的
怎么样 才能 让 自己 变得 有 力气	怎么样 才能 让 自己 更 强壮 ， 更 有 力气	推荐 几个 好玩 的 小游戏 ！
微 信 怎么 设置 头像	微 信 头像 如何 设置	怎样 健康 减肥
帮忙 取 个 名字 。	帮忙 取 个 名字 ，	什么 品牌 的 手表 好
冬季 奥运会 是从 哪一年 开始 举办 的 ？	冬季 奥运会 圣火 采集 仪式 是从 哪一年 开始 的 ？	先 说明 触礁 是 什么 意思 ， 什么 情况 没 危险
苹果 手机 怎么 买 天天 酷 跑 的 钻石 啊	苹果 手机 怎么 买 天天 酷 跑 钻石	玩 联盟 ， 你 最 喜欢 用 哪个 英雄 ？
射精 快 是 什么 原因 ？	射精 快 是 什么 原因	你 最 喜欢 的 电视剧
求 推荐 好看 的 电影	求 推荐 好看 的 电影 ！	有 什么 丰胸 产品 是 真的 有效 的
北京 的 丰台区 是不是 北京 最 乱 的 地方 ？	北京 有 什么 地方 买 鸟 啊 ? 最好 是 东城 的	如何 吃 红毛丹
娶 什么样 的 女人 做 老婆 最好 ？	什么样 的 女人 做 老婆 最好 ？	为什么 下载 了 问道 玩 不了
竖 式 乘法 验算 。	竖 式 和 乘法 验算	老公 过生日 做 什么 菜 好 吗
哪个 输入法 好 用 ？	输入法 哪个 好 用 ？	电脑 上 有 什么 好玩 的 单机游戏 吗 ？
为什么 别人 打 不通 我 的 手机	怎么 让 别人 打 不通 我 的 手机	怎么样 才能 死 ？
南方 和 北方 哪个 好	我 的 南方 与 北方	如何 锻炼 自己 的 口才 ！
那里 有 植物 大战 僵尸 卖	植物 大战 僵尸 在 哪里 下 ？	什么 牌子 的 空压机 好 有 哪些 呢
什么 呼应 什么 的 成语	成语 啥 个 相 呼应	现在 谁 是 中国 首富 ？
重生 鸿蒙 类 小说	重生 鸿蒙 类 小说 、	现在 做 什么 工作 最 挣钱
怎样 在 网上 买 电影票	如何 在 网上 买 飞机票	贴 吧 小尾巴 怎么 设置 ？
眼见为实 的 上 一句 是 什么	眼见为实 的 上 一句 是 什么 ？	求 大神 帮忙 ， 有关 会计 ， 工作 的 ，
万圣节 送 什么 礼物 给 女朋友	万圣节 给 女朋友 送 什么	深圳 龙华 富士康 集团 还 招 人 吗 ？
苹果醋 什么 牌子 好 。	什么 牌子 的 苹果醋 好 ？	那 您 提供 一下 金额 和 时间 。
酷 狗 和 天天 动听 哪个 更好 用 ？	酷 狗 和 天天 动听 哪个 好	人家 说 吃 猪肉 是 什么 意思
亲爱 滴 是 什么 意思	称 亲爱 的 是 什么 意思	太极 气功 十八式 口令 音乐
淘宝 子 账号密码 怎么 修改 ？	淘宝 子 账号 怎么 添加 在 网页 上	饱经风霜 是 什么 意思 啊
怎么 修改 百度 知道 的 用户名 ？	百度 知道 要 怎么 改 用户名 ？	什么 黄金 好
想 提高 英语 成绩	怎么 才能 提高 羽毛球 技术	我 的 世界 生存 模式 鞍 怎么 用
伊利 奶粉 怎么 积分 ？	伊利 奶粉 怎么 积分	葫芦 侠 怎么 使用 ？
学 霸 ， 帮忙 ！	是 学 霸 的 帮忙	孤独 虽败犹荣
目前 的 智能 安全 防护 体系 已 能够 实时 保护 用户 的 账户 和 资金 安全 ~	保险公司 出具 信用 保证 保险 ， 对 本次 借款 的 应 还 本金 和 利息 提供 保险 保障 。	主见 性 强 什么 意思 啊
这 是 哪部 动漫 的 ？	这 是 哪部 电影 … 看 图 …	地下城 与 勇士 好玩 吗 ， 选 哪个 职业 最好 啊
您 是 什么 提交 的 受理 单	您 订单 类型 选择 理财 订单	现在 的 国家 主席 是 谁
余额 宝 怎么 办理 ？	怎样 办理 余额 宝 ？	有 哪些 国产 喜剧电影 （ 爆笑 ）
岑 参 是 哪个 朝代	岑 参 是 哪个 朝代 的	子宫 双 附件
梦见 自己 与 别人 打架	梦见 我 和 别人 打架	分手 还 能 做 朋友 吗
汪东城 的 老婆 是 谁 汪	刘 烨 的 老婆 是 谁	男人 精子 受 女人 哪里 才 会 怀孕
女人 吃 什么 最好	女人 吃 什么 豆 最好	建议您 电脑 端 来访 提供 一下 您 的 截图 ， 这边 核实 一下 的 ， 辛苦 您 了 。
在家 带 小孩 怎么 赚钱	有 什么 工作 适合 在家 带 孩子 做 的	生肖 算 农历 还是 新历
开 女装 店 ， 起名	如何 给 科技 公司 起名 ？	有 一部 新 动漫 ， 求
微 信 上 的 好友 删除 了 对方 还有 我 的 吗	微 信 我 把 一个 好友 删除 以后 的 问题	梦见 捡 棉 衣服 穿 是 什么 意思
婴儿 手推车 多少 钱 婴儿 手推车 什么 牌子 好 啊 ?	婴儿 手推车 多少 钱 婴儿 手推车 什么 牌子 好 啊 ? 谢谢 啦	男 属 虎 女 属 猴 合 吗 ？
外国 诗人 有 哪些	都 有 哪些 外国 诗人 写 的 诗 好 啊	什么 品牌 的 裤子 好
《 饥荒 》 玩 不了	玩 魔 道 在 优 酷 出 视频	姜 潮 有 女朋友 么
我 爷爷 堂哥 的 儿子 的 女儿 我 应该 叫 什么	我 表哥 ， 堂哥 的 儿子 或 女儿 叫 我 什么 ？	飞机 上 座位 怎么 找 ？
怎么 开通 流量 加油 包	怎么 开通 流量 加油 包 。	孕妇 梦见 买 蜡 什么 意思
带鱼 上 的 白 鳞 可以 吃 吗 ？	带鱼 的 鳞 能 吃 吗 ？	老虎 的 左 耳朵 像 什么 ？
济南 的 美容 整形医院 哪家 做 光子 嫩肤 最好 ？	深圳 哪家 美容 医院 的 光子 嫩肤 效果 好	有 什么 好看 的 发型 。 ( 男生 的 )
柳 市镇 哪里 有 手工 活 拿 回家 做 的	义乌 哪里 有 饰品 手工 活 拿 回家 做	过 春节 的 国家 有 哪些
捡 肥皂 是 什么 意思 ？	捡 肥皂 是 什么 意思	怎么 下载 免费 歌曲
马铃薯 是 土豆 吗 ？	马铃薯 就是 土豆 吗 ？	好久不见 ， 你 还好 吗 ？
这 是 什么 品种 的 狗狗 ？	这 是 什么 品种 狗狗	燃气 热水器 哪个 品牌 的 好
诚征 中老年 服装 批发商	购买 中老年 服装	维权 退款 的 您 可以 咨询 下 淘宝 那边 看 下 那边 退款 目前 是 什么 情况
您好 ， 请问 您 是 什么 还款 呢 ？	请问 是 忘记 了 安全 保护 问题 答案 是 吗 ？	群 头像 怎么 设置
谁知 道谢 娜 和 刘 烨 分手 的 真正 原因 呢 ?	刘 烨 和 谢 娜 什么 时候 分手 的	超市 怎么 进货 ？ 在 哪里 进 ？
福州 哪里 有 旧 照片 翻新 的 店 ！	福州 那里 有 旧 照片 翻新 ？	求 类似 《 恐怖 游轮 》 的 电影 ！
我 该 怎么 学会 与 人 沟通 ?	内向 的 人 怎么 学会 与 别人 沟通 和 交流	什么 产品 减肥 效果 好 ？
栖 的 近义词 怎么 组词	鹰 的 近义词 组词	明星 一般 都 是 怎样 减肥 的 ？
如何 解除 继 父子关系	如何 解除 父子关系 ？	女人 为什么 爱美
猴子 喜欢 吃 香蕉 , 狒狒 喜欢 不 ?	猴子 为什么 喜欢 吃 香蕉 ， 为什么 它 不 喜欢 吃 榴莲	刘 诗 诗 喜欢 吴奇隆 吗 ？
打雷 对 电脑 有 影响 吗	打雷 对 电脑 有 影响 么 ，	老婆 偷人 我 该 怎么办 ！
这 是 什么 。 牌子 的 导航	这 是 什么 牌子 的 导航 ？	血 粘稠 吃 什么 药 ?
苹果 手机 怎么 识别 真假	怎么 识别 苹果 手机 真假	世界遗产 有 哪些 ？
睾丸炎 药 吃 什么 药	睾丸炎 看 什么 科 ？	用 什么 牙膏 牌子 好 ？
天天 酷 跑 那个 角色 最好 用	天天 酷 跑 角色 哪个 最好	奔跑 吧 兄弟 电影 在 哪里 能 看 ？
一般 大家 去 哪个 网站 买 书 。	大家 买 书 一般 上 哪个 网站 买 ？	阐 幽 护肤品 怎么样 ， 有 谁 用 过
有 好 的 可以 瘦 脸 的 方法 吗 ？	淘宝 上 有 什么 好 的 茶叶 可以 买 ？	江西省 省会 是 哪里 ？
能 介绍 一本 好书 吗 ？	怎样 找 一本 好书	美 瞳 哪个 牌子 薄
您好 ， 如 没有 的话 是 不 支持 的	是 的 ， 如果 您 的 产品 没有 到期 的话 是 需要 收取 手续费 的	苹果 手机 是 那个 国家 生产 的 ？
梦见 很多 的 桑椹 是 什么 意思 啊 ？	梦见 很多 大便 还有 很多 鱼 ， 请问 是 什么 意思 啊 ？	谁 能 告诉 我 这 条 狗 是 什么 品种 啊
吃 什么 才能 美 白 呢	喝 什么 茶 可以 美 白 ？	郑州 有 那些 好 的 幼师 学校
姓 蓝 的 是 什么 少数民族	有 什么 少数民族 贴 吧 吗	男 包 什么 牌子 好
安 卓 手机 有 什么 好玩 的 单机游戏	有 什么 好玩 的 手机 安 卓 单机游戏	可 下载 的 电影 网站 推荐
帮忙 起 个 店名 吧 ！	帮忙 起 个 店名 吧 ～	兔子 为什么 喜欢 吃 萝卜
网易 寻找 懂 球 帝 ， 这位 主教练 是 谁 ？	寻找 懂 球 帝 ， 猜猜 这 名 球员 是 谁	什么 歌 适合 做 手机 铃声 女生 用 ，
姜 潮 有 女朋友 么 》 ？	姜 潮 有 女朋友 么	小说 《 和 校花 同居 的 日子 》 里 的 哈 院
你们 喜欢 看 什么 电视剧 呢 ？	你们 最 喜欢 看 什么 电视剧	怎么 写 过年 的 作文
好听 的 四个 字 名字	四个 字 好听 的 名字	寻找 懂 球 帝 ， 猜猜 这 名 球员 是 谁
求 百日 蔷薇 漫画	求 百日 蔷薇 漫画 【 全 】	为什么 腾讯 所有 的 网页 游戏 都 上 不 去 了
什么 毒 无色 无味	什么 毒 无色 无味 …	学 而 时 习 之 的 之 什么 意思 ？
我 的 世界 怎么 刷 石头	我 的 世界 火 石头 怎么 得	她 叫 什么 名字 ， 好 喜欢 她
需要 您 同意 然后 转接 过去 ， 您 看 可以 吗	亲 按照 常理 说 你 既然 找回 成功 了 可能 是 你 输入 的 时候 没有 注意 大小写 的 问题	什么 叫 包子 萌 ？
微 博 怎么 赞 话题	微 博 怎么 刷 话题	火影 作者 死 没
电脑 怎么 玩 天天 酷 跑	天天 酷 跑 怎么 玩 不了	到 鼓浪屿 旅游 一般 要 花 多少 钱 ？
超人 和 奥特曼 谁 厉害 ？	奥特曼 和 超人 谁 厉害	小 脸型 适合 什么 帽子
有 什么 好看 的 打篮球 电影 ？	有 什么 好看 的 篮球 电影 和 好 听的歌 吗	空气 刘海 是 怎么样 的
狗狗 品种	狗狗 的 品种	爽 的 第三笔 是 什么
全国 物理 奥林匹克 竞赛 怎么 参加	怎样 自学 高中物理 ， 参加 竞赛	怎么 学会 沟通
最近 有 什么 好 听的歌 ？	最近 有 什么 好 听的歌 吗	北京 逛街 哪里 好
肾虚 的 女人 吃 什么	女人 肾虚 吃 什么 好	今年 几号 春运 开始
羡慕 的 反义词 是 什么	求 羡慕 的 反义词 是 什么	男人 都 忘不了 他 的 初恋 吗 ？
哪个 牌子 的 去 黑头 好 ?	哪个 牌子 去 黑头 的 效果 比较 好	单身 情人节 你们 怎么 过 ？
怎么 报复 背叛 我 的 男友 ?	怎么 报复 背叛 自己 的 男友	请问 这 是 什么 漫画 的 ？
男 属 牛 女 属 猴 合适 吗 ？	男 属 虎 女 属 猴 合 吗 ？	去 哪儿 特价机票
现在 什么 好 赚钱 吧 ？	现在 敢 什么 事 赚钱 。	小鬼 是 真的 吗
杭州 到 成都 有 动车 吗 ？	杭州 有 到 成都 的 动车 吗 ？	入团 申请书 600 字
百度 账号 能 改名字 吗	的 昵称 能 改 吗	刷 票 刷 出 什么 了
陈世美 是 什么 生肖 ？	陈世美 是 指 什么 生肖	这 是 什么 东西 ， 我 的确 不 知道
毛孔 大 怎么 收缩	怎么 去 收缩 毛孔	含有 龙 与 虎 字 的 成语
请问 不是 您 的 账户 吗 ？	您好 ， 请问 您 使用 的 邮箱 类型 是 ？	网上 交 话费 怎么 交
推荐 个 手机游戏	手机游戏 推荐	洛克 王国 洛克 快 打 在 哪
剑灵 为什么 老 是 掉线	为什么 我 剑灵 老 是 掉线	翻译 一下 这个 吧 … 谢谢
微 信 为什么 添加 联系人 失败 ？	为什么 微 信 没有 漂流瓶 ？	异地 恋 什么 意思
您好 ， 支付宝 小 二 很 高兴 为您服务 !	请 说 ， 小宝 很 高兴 为您服务 ~ < p > < / p >	宜昌 三峡 论坛 的 邀请 码
您好 ， 目前 支付宝 只是 您 的 这个 第三方 的 付款 的 平台 是 不 销售 任何 的 产品 的	很 抱歉 的 亲 ， 支付宝 仅 为 付款 平台 ， 您 拍 下 的 话费 是 由 淘宝 卖家 或 运营商 发货	放 烟花 日记 400 字 急急 急 ！
麻烦 您 优先 操作 一下 的 ， 辛苦 您 了 。	麻烦 您 提供 一下 您 的 店铺 的 链接 ， 帮 您 测试 一下 的 ， 辛苦 您 了 。	梦见 别人 劝 自己 出轨
日文 怎么 打 ？	问 个 日文 怎么 打	请问 是 什么 交易 的 退款 ， 亲
福建 林业 职业 技术 学院 的 情况	福建 林业 职业 技术 学院 美女 ？	世界 上 最大 的 岛屿 是 哪个 ？
两个 胖子 结婚 ( 打 一 城市 )	两个 胖子 拥抱 ( 打 一 地名 )	求 一部 老 电视剧 ( 古装 )
大家 都 用 哪家 转运 公司	加盟 哪个 网店 公司 好 呢	怎样 让 头发 长 得 快点 ，
手机电池 充电 太慢 什么 原因	手机 充电 慢 ， 什么 原因 ， 怎么办	城市 发展 模式
爸爸 去 哪儿 第三季 的 人 有 谁	爸爸 去 哪儿 第三季	小 鸽子 出 了 一个月 老 鸽子 还 不 下蛋 为什么
从 逸仙路 安 汾 路 怎么 到 大宁 灵石 公园	从 五角场 到 大宁 灵石 公园 怎么 走 ？	微 信 怎么 更改 银行卡
什么 时候 可以 开始 刮胡子 ？	当 什么 时候 可以 刮胡子	怎么样 才能 中 双色球 一等奖
杭州 到 云南 旅游团 哪个 好	云南 好 ？ 还是 杭州 好 、	胡子 长 的 太 快 怎么办 ？
慢性 湿疹 用 什么 药 ？	慢性 湿疹 吃 什么 药 ？	我 想 为 自己 的 名字 设计 个性 签名
网上 兼职 有 什么	元旦 有 在 西安 找 兼职 的 吗	梦见 很多 大便 还有 很多 鱼 ， 请问 是 什么 意思 啊 ？
今年 端午节 如何 放假	今年 端午节 怎么 放假	这 是 什么 手机游戏 啊
人情债 怎么 还	人情债 怎么 还 ？	怎么样 注销 淘宝 帐号
我 不会 唱歌 是 谁 唱 的	我 不会 唱歌 怎么办	这个 妹妹 漂亮 吗 ？
贴 吧 里 怎么 设置 头像	群 头像 怎么 设置	求 一个 卡通 情侣 头像
联合国 最大 的 是 谁 ？ 是 联合国 秘书长 ？	联合国 秘书长 潘基文 是 哪 国人 ？ 具体 的 资料 ？	这 是 什么 香水 ， 怎么 读
请问 这个 头像 叫 什么 ？	请问 ， 这个 头像 什么 狗 ？	天下足球 是 哪儿 啊 ？ 做 什么 的
郭 德 纲 的 新 段子 那些 好	郭 德 纲 的 段子	广州 哪里 有 小吃街
您好 . 您 的 情况 必须 让 这个 邮箱 可以 接受 邮件 才 可以	您好 . 您 的 情况 建议您 使用 更加 稳定 的 阿里 云 邮箱 即 可以 了 .	看 图 猜 电影 ！
什么 电视剧 有 黑社会 片 ？	关于 黑社会 的 电视剧 叫 什么 ？	怎么 更改 绑定 微 信 的 手机号
我 的 世界 手机 版 存档 怎么 用	我 的 世界 手机 版 谁 能 和 我 远程 联机	您好 ， 密码 锁定 辛苦 您 等待 三 小时 后 会 自动 解锁 的 ， 辛苦 您 了
去 美容院 护肤 好 吗	到 美容院 做 护肤 其实 好不好 ？	请问 下 图片 这个 女 的 叫 什么 名字 ？
桃子 老师 和 四个 学生 发	桃子 老师 与 四个 学生	这样 的 脸型 剪 啥 发型 好看
怎样 宣传 自己 的 网店 ？	开 网店 怎样 做 宣传	百度 推广 工具
这 是 什么 字 ？ 腈 怎么 组词	这 是 什么 字 ？ 怎样 组词 ？	鲍鱼 怎么 做 好吃
为什么 我 注册 不了 支付宝	为什么 登陆 不了 淘宝	现在 流行 染 什么 颜色 的 头发
江苏 技术 师范学院 是 要 改名 为 华东科技 大学 吗 ？	江苏 技术 师范学院 的 住宿 情况 怎么样 啊 ?	核实 您 的 这个 资金 的 转账 是 处理 中 的 ， 目前 是 需要 您 在 今天 的 24 点 之前 关注 的
奥比 岛 怎样 帮 精灵 升级	奥比 岛 怎样 能 让 小精灵 升级 形态	淘宝 代理 怎么 做
双 项 淘宝 客 怎么 做	如何 才能 在家 兼职 淘宝 客服	感冒 能 吃 香蕉 吗 ？
周杰伦 和 蔡依林 分手 是 谁 提出 的 ？ 雅虎 知识 堂	蔡依林 和 周杰伦 到底 什么 关系 ？	如何 在 网上 买 飞机票
木瓜 怎么 煮 才 好吃	木瓜 怎么 做 好吃	你 的 生活 过 的 幸福 吗 ？
答案 已知 求 过程	已知 答案 ， 求 过程	《 玩 》 的 作文 开头 怎么 写 ？
金毛 和 拉布拉多 的 区别	拉布拉多 和 金毛 区别	网上 怎么 转账 ？
什么 人 只 隔 一夜 就 变 老 ？	什么 人 只 隔 一夜 就 变 老	很 抱歉 的 亲 ， 支付宝 仅 为 付款 平台 ， 您 拍 下 的 话费 是 由 淘宝 卖家 或 运营商 发货
怎样 运动 减肥 最快 最 有效	怎样 减肥 最快 最 有效 运动	有 哪些 游戏 和 植物 大战 僵尸 类似
搜 一部 关于 恐龙 的 电影	关于 恐龙 的 一部 电影	淘宝 怎么 取消 快捷 支付
中国 海洋大学 图书馆 的 听力 书 , 听力 在 哪	中国 海洋大学 浮山 校区 的 图书馆 藏书 多 吗 ？	中国 的 四大 古城 有 哪些 ? 5
电灯 是 谁 发明 的 啊	谁 发明 了 电灯	这 句 话 日语 怎么 说
现在 淘宝 做 什么 好 ？	淘宝 现在 做 什么 好	在 家里 有 电脑 怎么 挣钱
收集 点 室内设计 国外 的 设计师 网站	家 纺 设计 国外 资料 网站	什么 美 剧 好看 。
男士 手表 什么 品牌 的 好	男士 手表 什么 品牌 好	怎样 注册 阿里巴巴 ？
这个 发型 ， 叫 什么 ？ 怎么弄 ？	这个 发型 怎么弄 ， 叫 什么 ？	火 的 正确 笔顺
安徽 警官 职业 学院 能否 专升本	安徽 警官 职业 学院 怎么样 ？	给 宝宝 起 个 乳名 是 个 男孩
灰指甲 挂 什么 科	咳嗽 老 不好 ， 挂 什么 科	河水 像 什么 有关 的 字
借花献佛 是 什么 意思	借 佛 献花 是 什么 意思	怎么 看 音标 把 英语单词 读出来 啊
金 立 手机 怎么 截图 ？	如何 学习 好 摩斯 密码	的 昵称 能 改 吗
您 设置 了 默认 的 付款 方式 了 吗	您 可以 再 服务 窗 搜 花 呗 也 可以 的	挖掘机 学校 哪家 强 。
测试 你 的 前世 是 什么 ?	测试 一下 你 的 前世 是 个 什么 人	男生 斜 刘海 怎么 吹 ？
这 张 图 是 哪个 动漫 的 ？	求 这 张 图 的 动漫 ！	有 新 电影 介绍 吗
有 儿子 跟 自己 亲妈 发生 关系 的 吗 ？	你 也 和 你 儿子 发生 关系 ？	这个 玉镯 的 价格
这个 游戏 的 名字 是 什么 ？	这个 游戏 名字 叫 什么	花 呗 目前 系统 更新 维护 ， 稍后 可 恢复正常 ， 请 您 今日 晚些时候 操作 。
人口密度 怎么 算 ？	人口密度 是 怎么 算 的	介绍 部 你 最 喜欢 的 电视剧 。
世界 上 最大 的 岛屿 是 什么 岛屿 ？	世界 上 最大 的 岛屿 是 哪个 ？	日语 可爱 怎么 说 ？
淘宝 上 卖家 发货 了 没收 直接 退回 能 申请 退款 吗	淘宝 卖家 24 小时 未 发货 ， 申请 退款 能 成功 吗 ？	粉色 和 什么 颜色 最 搭
有 谁 在 扬州 租房 ？	广州 花城 广场 有 什么 ， 怎么 去 。	淘宝 的 用户名 怎样 修改
就 叶子 看 ， 这 是 什么 植物	这 是 什么 植物 的 叶子	爸爸 去 哪儿 贝 儿 贱
联通 卡 可以 用 移动 手机 吗	联通 3g 手机 能 用 移动 卡 吗	跪求 北京 哪里 能 买 到 日文 原版 的 轻 小说 ？ 自己 看 分
王 俊 凯 喜欢 女生 什么	王 俊 凯 喜欢 什么 女生	什么 牌子 家用 跑步机 好
大家 是否 考虑 去 德国 留学 ？	如何 去 德国 留学 ?	国产 助听器 什么 牌子 最好
亚马逊 好 还是 京东 好	京东 好 还是 亚马逊 好 ？	这种 围巾 怎么 织 什么 织法
搜 片 神器 怎么 不 可以 用	搜 片 神器 下载 了 怎么 不能 用	中国 动漫 有 什么 好看 的 吗
伴郎 穿 什么	当 伴郎 穿 什么 ？	CLUCL 是 什么 牌子 包包 。
野 蘑菇 有毒 吗 ？	这 蘑菇 有毒 吗 ？	肚子疼 不 拉肚子 是 怎么回事
怎么 让 我 看清 一个 人	怎么 看清 一个 人 ？	湖北 生态 工程 职业 技术 学院 的 环境 怎么样 ？
小米 手机 怎么 破解 付费 主题	小米 主题 怎么 破解 破解	日语 と い え ど も 是 什么 意思
这个 是 什么 字体 的 英文	这个 英文 字体 叫 什么	国内 咨询 公司 中 哪家 的 房地产 咨询 做 的 比较 好 啊 ？
24 小时 退款 的	您 截图 4 月 6 号 到 4 月 8 号 的 收支 明细 给 我 ，	怎么 使 胸 变 大 ？
孕妇 喝 什么样 酸奶 好	新生儿 喝 奶粉 该 喝 多少 ？	怎么 对付 婆婆
能 给 我 火影 同 人 漫画 吗	还有 火影 同 人 漫画 吗	人 是 怎么 睡着 的
单机游戏 下载 哪个 网站 好	下载 单机游戏 哪个 网站 好	全民 枪战 的 人 怎么 飞
水浒传 作者	火影 作者 死 没	这个 图片 是 哪部 动画片 ？
喜事 连连 指 什么 生肖	喜事 连连 是 什么 生肖 ？	手机 所有 图片 都 不 显示
石膏线 是 怎么 安装 的 ？	如何 安装 石膏线	求 恋爱 棱镜 的 漫画 。
浙江 有 什么 好玩 的 地方	浙江 有 什么 好玩 的 地方 ？	保险公司 出具 信用 保证 保险 ， 对 本次 借款 的 应 还 本金 和 利息 提供 保险 保障 。
这 是 什么 昆虫	这 是 什么 小 昆虫 ？	怎么 查 别人 通话记录
联通 卡 怎么 取消 来电显示	联通 卡 怎样 开通 来电显示	我 经常 出差 ， 如何 随时 查询 发票 的 真伪 ？
关于 《 我 的 世界 》 小 地图	我 的 世界 有 这样 的 地图 吗 ？	鸟儿 为啥 会 飞
怎么 用 手机 遥控 电视 ？	怎么 用 手机 复制 电视 遥控器	怎样 能 快速 忘记 一个 人
求 《 鬼畜 眼镜 》 的 漫画 全集	求 《 鬼畜 眼镜 》 漫画 全集	我 想 看 一起 再 看 流星雨 ，
我 的 微 信 密码 忘 了 怎么 找 的 回来 啊	微 信 密码 忘 了 怎么 找 回来	没有 工作 ， 可以 办 信用卡 吗 ？
水粉 颜料 什么 牌子 好	水粉 颜料 什么 牌子 的 好 ？	怎么 看清 一个 人 ？
在 深圳 哪里 去 找 工作	在 杭州 找 工作 去 那里 找	辛苦 您 在线 等待 下 的 现在 帮 您 转接 的 好 吗 ？
隐形眼镜 正反面 怎么 区分 阿 ？	隐形眼镜 怎么 区分 正反面	谁 见 过 杨 幂 的 这 张 照片 ？
高铁 和 动车 那个 快 ？	高铁 与 动车 的 区别 ？	求 欧美 动漫
我国 四大发明 有 什么	我国 的 四大发明 是 什 麽	老人 手机 什么 牌子 的 好 ?
您 是 说 的 余额 宝 吗 ？	亲 ， 您 是 说 余额 宝 的 吗 ？	为什么 微 信 没有 漂流瓶 ？
人流 后 能 吃 干 桂圆 吗	怀孕 吃 干 桂圆 好 吗	怎样 能 让 胡子 长 的 浓密 点
十二生肖 有 什么	十二生肖 都 是 什么	怎么 查询 邮政 快递
残阳 是 什么 意思	残阳 什么 意思	无线 上网卡 和 无线 路由器 怎么 用
天下足球 址 是 什么 呢 ？	天下足球 是 哪儿 啊 ？ 做 什么 的	如何 注册 淘宝 帐号
子宫 附件 彩超	子宫 双 附件	忘情水 是 谁 给 刘德华 的
用 手机 怎么 打 特殊符号	手机 怎么 才能 打出 特殊符号	路由器 怎么 设置 网速 限制
北京 哪个 眼科医院 最好	中国 哪个 地方 钱 最好 赚	什么 牌子 的 机顶盒 好
脖子 上 有 痣 代表 什么	左 脖子 上 有 痣 代表 什么 女 的	借 佛 献花 是 什么 意思
这样 的 青蛙 有毒 吗	青蛙 有毒 吗 ？	投资 理财 的 小 故事
八年级 下册 数学	八年级 下册 数学 。	民政局 星期六 星期天 有 上班 吗 ？
英语 该 怎么 读 好	如何 读 好 英语	请问 这 东西 有 什么 用 ？
月经 来 的 时候 能 喝茶 吗 ？	吃 中药 了 什么 时候 才 可以 怀孕	求 羡慕 的 反义词 是 什么
姐妹 头像 、 网名 、 个性 签名	超 拽 超 霸气 不 带 字 女生 头像	“ 春江 水暖鸭 先知 ”
异地 的 银行卡 怎么 注销 ！	如何 异地 注销 银行卡	电子 贺卡 怎么 制作
南宁 有 啥 好玩 的 地方 ？	南宁 有 什么 好玩 的 地方 ？	这种 发型 叫 什么 ？
是 什么 电影 里 的 台词 ？	邓 紫 棋 有 一首歌 ， 啊 啊 } 是 什么 ？	怎么 发 匿名 悄悄话 ？
不 带 字 女生 头像	女生 头像 不 带 字	谁能给 我 搭配 正确 的 减肥 方法
重庆 哪里 可以 滑雪	重庆 哪里 能 滑雪	脾 肾阳虚 吃 什么 药 好
支付宝 和 网 银 一样 吗	网 银 和 支付宝 一样 吗	有 什么 好看 的 玄 幻 魔法 小说 么
上海 大 的 装修 公司	上海 大计 数据 公司 怎么样 啊	关于 北京烤鸭
请 大家 帮忙 这个 电影 是 ？	大家 帮忙 看 下 这 是 什么 狗	为什么 小孩子 喜欢 吃糖 呢 ？
长寿 花 什么样 的	长寿 花 什么样 啊	一片 叶子 能 做 面膜 吗 ？
谁 能 告诉 我 这 狗 什么 品种 的 。	谁 能 告诉 我 这 条 狗 是 什么 品种 啊	指 打扰 别人 的 美梦 是 什么 成语
安徽 卫视 当红 不让 的 两个 主持人 叫 什么 ?	谁 知道 安徽 卫视 那个 女 主持人 的 名字 ？	我 的 世界 里 石头 在 哪 挖
麻烦 您 提供 一下 接受 短信 的 手机号 ， 辛苦 您 了	麻烦 您 提供 一下 您 接受 短信 的 手机号 ， 辛苦 您 了	写 网游 的 小说 ！ 来 几部 吗 ？
稍 等 的 ， 正在 为 您 转接	辛苦 您 在线 等待 下 的 现在 帮 您 转接 的 好 吗 ？	李医生 去 痘 的 产品 效果 怎么样
请问 这 是 什么 树 的 叶子 啊 ？	请问 这 是 什么 木头 手串 ， 怎样 ？	深圳 哪家 美容 医院 的 光子 嫩肤 效果 好
今天 是 什么 日子 ， 都 在 放鞭炮	今天 是 什么 节日 ， 这么 多 放鞭炮 的	这个 视频 背景音乐 是 什么 啊
这 是 什么 手机游戏	这 是 什么 手机游戏 啊	一部 舒淇 的 电影
请 您 核实 下 您 是否 有 其他 的 支付宝 账户 的 ， 辛苦 您 了	您好 ， 请 您 核实 一下 其他 的 账户 是否 有 的 。 辛苦 您 了	您好 ， 辛苦 您 按照 上述 的 步骤 操作 一下 重置 支付 密码 的 ， 麻烦 了 。
短发 弄 什么 发型 好	男 的 ， 短发 能 做 什么 发型 呢 ？	这 是 什么 意思 ， 翻译 一下
邮政 快递 怎么 查询	怎么 查询 邮政 快递	想 找 个 能 在家 上班 的 工作 。
这个 头像 大 图	求 这个 头像 大 图 ！	查询 您 的 话费 卡 充值 时 您 是 选择 错误 面额 所以 需要 您 等待 三天 恢复 的
李小龙 为什么 那么 厉害	李小龙 那么 瘦 怎么 那么 厉害	竖 式 和 乘法 验算
截然不同 什么 意思	截然不同 的 意思 是 什么	魔兽 世界 钓鱼 和 烹饪 有用吗 ？ 能 赚钱 吗 ？
求 范冰冰 的 苹果 完整版	求 范冰冰 苹果 完整版 ？ 谁 有	能 不能 把 蓝 底 照片 帮 我 改成 红底 的 呀 ？
怎么 在 网上 找 客户 ？	怎么 在 网上 找 资料 ？	我 的 支付宝 密码 在 手机 上 怎么 找回
传统 日本 女人 穿 和服 时 穿 什么样 的 内衣 ？	为什么 日本 女人 穿 的 衣服 后面 都 带 一个 枕头 呢	水粉 颜料 什么 牌子 的 好 ？
这 是 什么 意思 翻译 一下	这 是 什么 意思 ， 翻译 一下	敏感 的 反义词 是 什么 ？
妈 蛋 是 什么 意思 ？	妈 蛋 什么 意思	求 重生 娱乐圈 耽 美文
我 的 世界 钻石 在 哪里 得 。	坦克 世界 金币 卡 哪里 买 的	如何 在 网上 买 飞机票
求 一款 网页 游戏 ！	找 一款 网页 游戏	香肠 腿 什么 意思
哪里 有 卖 货架 我	哪里 有 卖 货架 的 ？	这个 项链 是 什么 牌子 ？
现在 最 流行 的 玩具 是 什么 ？	现在 流行 什么 玩具 ？	隐形眼镜 怎么 区分 正反面
这个 兰花 是 什么 品种 ？	这 只 兔 兔 是 什么 品种 ？	什么 牌子 的 女士 连裤袜 质量 比较 好 而且 价格便宜
燃气 热水器 多 大 合适	燃气 热水器 排名	中国移动 信号 塔
什么 品牌 布艺沙发 好	什么 品牌 的 裤子 好 穿	暖 暖 忘记 密码
为什么 把 乌龟 叫 王八 ？	请问 ： 为什么 王八 是 乌龟	为什么 我 剑灵 老 是 掉线
肾虚 会 掉头发 吗 ？	肾虚 会 掉头发 吗 ，	麻烦 您 提供 一下 您 的 店铺 的 链接 ， 帮 您 测试 一下 的 ， 辛苦 您 了 。
刘德华 的 女儿 叫 什么 名字 啊	她 叫 什么 名字 ， 好 喜欢 她	怀孕 了 可以 做爱 吗
我 的 世界 中文版 下载	哪里 可以 下载 我 的 世界 中文版	蹉跎 是 什么 意思 ？
窥 的 形 近 字 急急 急	放 烟花 日记 400 字 急急 急 ！	蝇 可以 组成 什么 词
周杰伦 什么 时候 结婚	周杰伦 什么 时候 会 结婚	自己 怎么 装 无线网
鼓舞 意思 是 什么	鼓舞 是 什么 意思	心旷神怡 的 意思 是 什么
世界 上 最 难听 的 是 什么 歌 ？	世界 上 什么 歌 最 难听 ？	飞车 离婚 怎么 离 ？
麻烦 您 提供 您 的 姓名 ） ， 辛苦 您 了 ，	请问 您 是 在 参加 什么 活动 呢 ？ 麻烦 您 提供 一下 活动 名称 ， 辛苦 您 了	爱哭 的 动物 是 什么 生肖
榆林 在 哪个 省 ？	榆林 是 哪个 省 的	什么 东西 谁 都 不 愿意 吃 ？
爱情 保证书 怎么 写	爱情 保证书 怎么 写 ？	赵本山 今年 还 上 春晚 吗
周杰伦 会 和 蔡依林 结婚 嘛 ？	蔡依林 和 周杰伦 能 结婚 吗 ？	胃溃疡 是 什么 ？
天天 炫 斗 刷 钻石 是 真的 吗 ？	天天 炫 斗 刷 钻石 那些 是 真 得 吗 ？	花粉 少女 注意 报 漫画 求 发
网页 回合制 游戏	回合制 网页 游戏	谁 知道 这个 女优 的 名字 ？
这 是 什么 电视剧 ？ ！	猜 你 妹 ， 这 是 什么 电影 ？	这 不 不 孬 么 什么 意思
世界 有 神仙 吗	世界 有 神仙 吗 ？	赛尔 号 怎么 刷 经验 ？
130 * * * 这个 手机号 是 您 的 吗	137 * * * 这个 手机号 呢 ？	邓丽君 快 歌曲 有 哪些
可爱 吗 、 宝宝	我 宝宝 可爱 吗	我 的 世界 有 南瓜 林 吗
以 虫 治 虫 ， 治 什么 意思	以 虫 治 虫 的 治 是 什么 意思	连笔 签名 设计
百度 钱包 怎么样 ？	百度 钱包 怎么样	贝尔 发明 了 什么 ？
京东 商城 怎么 付款	京东 商城 是 怎样 付款 的 ？	请问 您 是 在 参加 什么 活动 呢 ？ 麻烦 您 提供 一下 活动 名称 ， 辛苦 您 了
就是 您 绑定 的 银行卡	建议您 解 绑 您 的 这 张 银行卡 ， 再 进行 重新 绑定 。	分享 迅雷 会员
是 我 的 淘宝 里面 可以 查看 到 的 哦	账单 导入 成功 ， 可以 在 该 信用卡 还款 页面 点击 该卡 一栏 查看 邮箱 账单 明细 ；	我 的 世界 怎么 造 工作台 阿 ！ 详细 点 ， 不然 不 采纳
怎么 在 微 信 上 制作 连接	苹果 手机 怎么 在 微 信 上 制作 链接	想 送 老公 生日礼物 送 什么 好 ？
谁 有 这 张 图 的 高清 大 图 ？	这 张 图 的 高清 大 图	咳嗽 老 不好 ， 挂 什么 科
哪里 有 正宗 福建 辣椒 王	哪里 卖 正宗 的 福建 辣椒 王	贱货 、 不要脸 的 英语 怎么 写
蓝牙 耳机 充电器 多少 钱 ？	苹果 五 原装 耳机 多少 钱	成都 的 水果 批发市场 在 哪里 ？
执意 的 意思 是 什么 ？	执意 是 什么 意思 ？	怎么 把 手机 支付宝 的 钱 转 到 余额 宝
关于 易语言 进度条	易语言 进度条 。	谁 知道 这 几张 图片 是 什么 动漫
非常 抱歉 给 您 添麻烦 了 ， 您 的 这个 是 无法 核实 的 ， 这里 是 不 显示 的	很 抱歉 . 您 的 这个 情况 小 二 只能 给 您 这个 建议 . 给 您 添麻烦 了 .	这 是 什么 叶子 的
我 是 好人 。	我 想 我 是 好人	梦见 我 自己 杀人
现在 最 流行 的 手机 铃声 是 什么	现在 流行 什么 手机 铃声	有 什么 软件 可以 赚钱 ，
历代 的 联合国 秘书长	联合国 现任 副 秘书长	为了 准确 核对 信息 ， 麻烦 您 提供 下 金额 　 和 　 收款 银行卡 的 名称 　 给 我 下 哦 ！
电脑 怎么 录像 ？	怎么 在 电脑 上 录像	我 的 世界 这个 是 什么 材质 包
移动 怎么 刷 钻	生死 狙击 刷 金币 软件 怎么 用	牛仔裤 配 什么 鞋子 好看 ？
怎样 让 胡子 长 得 更 浓密	怎样 让 胡子 长 得 浓密 点 ！	植物 人 大战 僵尸 破解版
中国移动 没 信号	中国移动 信号 塔	这个 是 什么 牌子 的 护手霜
形容 人 吝啬 的 成语	最 难 做 的 饭 — 成语	俗 的 反义词 并 和 俗 组成 成语
有 哪些 国家 也 过 春节 ?	过 春节 的 国家 有 哪些	高分 求 泰坦 之 旅 装备 修改器
奔跑 吧 兄弟 大 电影 为什么 没有 邓 超 ？	为什么 奔跑 吧 兄弟 大 电影 ， 没有 邓 超	求 好看 的 异 界 小说 ，
中国 首富 是 谁 现在 ？	现在 谁 是 中国 首富 ？	酷 狗 和 天天 动听 哪个 好
广东 石油化工 学院 好不好	广东 石油化工 学院 学校 风景	眼见为实 的 上 一句 是 什么 ？
我 怎样 在 百度 上 发帖	怎样 在 百度 上 发帖	仙人掌 的 刺 有毒 吗 ？
怎么 看出 自己 是不是 一个 备胎	如何 判断 自己 是否是 她 的 备胎	都 有 什么 软件 可以 用 信用卡 充值 呢 ！
支付宝 支付 密码 忘记 怎么办 ？	支付宝 支付 密码 忘记 了	关于 生化危机 浣熊 市 行动 的 问题
屏幕 分辨率 不 对 ， 怎么 调 ，	屏幕 分辨率 怎么 调	百度 一下 你 就 知道 是 谁 说 的
张家港市 属 哪里 管	杭州 下沙 属 什么 区	我 的 世界 怎么 吸水 工具
电视剧 爱情 回来 了 测	爱情 回来 了 电视剧	亲 ， 花 呗 设置 分期 是 可以 选择 0 % - 90 % 金额 做 分期 ， 不能 全部 做 分期 。
现在 什么 生意 投资 小 赚钱快	现在 做 什么 生意 投资 少 风险 小 ， 赚钱快	翀 字 的 含义 是 什么 ？
求 音乐 ： 你 是 我 的 眼 林 宥 嘉 伴奏	求 音乐 ： 情 锁 陈 思 安 伴奏	杏花 是 什么 颜色 的 ？
北京 哪里 最 繁华	北京 那里 最 繁华 ？	哪个 牌子 去 黑头 的 效果 比较 好
开 个 时尚 创意 餐 吧 大概 要 投资 多少	一般 开 个 创意设计 工作室 要 多少 钱	求 此 女 名字 ， 你 懂 的
上海 面积 多 大 ？	上海 到底 多 大 d ?	一盒 香烟 不 拆开 能 存放 多久 ？
2008 年 奥运会 足球 项目 为什么 在 开幕式 以前 进行 ？	在 第 几届 奥运会 上 , 足球 成为 了 正式 比赛项目	山东 威海 金海 渔业 股份 有限公司 招聘 是 真的 吗
如何 能 让 脸部皮肤 紧 致 ？	如何 紧 致 脸部皮肤	灰色 裙子 配 什么 颜色 上衣
怎么 制作 美 电子 贺卡	电子 贺卡 怎么 制作	美国 出入境 什么 东西 能 随身携带 ？
什么 狗 抓 兔子	兔子 吃 什么 死	其实 我 也 不 懂
什么 动物 代表 悲伤	什么 动物 代表 长寿	怎么 让 视频 变 高清
谁 是 世界 上 最 聪明 的 人 ？	世界 上 最 聪明 的 人 是 谁	一夫当关 的 后 一句 是 什么
月球 的 未 解 之谜	月球 还有 那些 未 解 之谜	赛尔 号 闪光 皮皮 怎么 抓 ？
为什么 玩 不了 梦幻 西游	梦幻 西游 为什么 玩 不了 ？	可以 的 ， 您 注销 成功 后 ， 可以 重新 注册 的 ， 辛苦 您 了 。
怎样 让 胸部 快速 变 大	胸部 怎样 快速 变 大	国 通 快递 怎么样
九阳 豆浆机 哪里 维修	九阳 豆浆机 在 哪里 可以 维修 ？	求 云南 的 大神 帮 我 解释 下 这 句 话 是 什么 意思 嘛 !
有 哪些 大 品牌 面膜	面膜 有 那些 品牌 好	善待 自己 的 意思 是 什么
约瑟 传说 的 幻 灵兽 怎么 打 ？	约瑟 传说 翼 灵兽 怎么 打	梦见 我 和 别人 打架
这 是 什么 叶子 ？	这 是 什么 叶子 的	加盟 哪个 网店 公司 好 呢
在线 签名 设计 免费版	签名 设计 免费版 在线 ，	终极 宿舍 过 了 做 什么
真的 十分 抱歉 ， 这个 是 需要 账户 本人 咨询 这边 才 是 可以 的	真的 十分 抱歉 这个 是 需要 账户 本人 咨询 这边 才 是 可以 的 。	飞机 杯 用来 是 什么 感觉 怎么 用
我 是 歌手 李 健 用 的 健身器材	我 是 歌手 里 李 健 用 的 那个 健身器材	晕车 有 什么 好 的 办法 解决 吗 ?
怎么 能 找到 一个 人	怎样 能 找到 一个 人 ？	是 学 霸 的 帮忙
安徽 含山 过年 的 习俗	安徽 过年 习俗	秦始皇 是 哪个 朝代 的 ？
怎样 让 头发 长 得 快点 ?	怎样 让 头发 长 得 快点 ，	关于 圆通 快递 的 速度
情不自禁 ， 禁 是 什么 意思	情不自禁 的 禁 是 什么 意思 呢 ？	什么 是 三农
购房 合同 抵押 贷款	购房 合同 公积金 贷款	为什么 日本 女人 穿 的 衣服 后面 都 带 一个 枕头 呢
北京 798 艺术 区 的 各个 展区 现在 还 开放 吗 ？	北京 798 艺术 区 里面 有 个 技校 叫 什么 名字 ？	韩 束 怎么 做 代理
找 一本 都市 重生 小说	求 一本 重生 都市 小说	穿越 小说 ， 到 唐朝 的
英文 怎么 读	这个 怎么 写 ， 英文	您 之前 操作 转账 是 怎么 成功 的 ， 就是 怎么 操作 的 ， 辛苦 您 了 。
请 大家 推荐 一部 手机	请 大家 推荐 一部 手机 。	支付宝 怎么样 才能 和 淘宝 绑定
用 没有 什么 就 没有 什么 造句	用 没有 和 也 不 造句	我 不 知道 要说 什么 ！
什么 的 小河 ，	什么 的 小河 ？	吹泡泡 水 怎么 做
纪念碑 谷 这 关 怎么 过	问道 中 妖魔 道 任务 找 谁 做	保暖 内衣 如何 保暖 ？
电脑屏幕 上 的 字体 有 残 影 ， 是 怎么回事 ？	我 得 电脑屏幕 图标 总 有 向 右 的 拖 影 是 怎么回事 啊	吃 中药 了 什么 时候 才 可以 怀孕
我 这个 脸型 什么 发型 好看 ？	这样 的 脸型 剪 啥 发型 好看	毕加索 和 回音 哥
怎么 快速 学会 唱 一首歌 ？	怎么 能 快速 学会 一首歌 ？	女性 保养 卵巢 吃 什么 产品 好
怎么 做 百度 推广 效果 好 ？	芯 漾 面膜 怎么样 ？ 好 做 么 ？	同桌 的 你 在 哪里 下载
跑跑 卡丁车 怎么 刷 骰子 ？	跑跑 卡丁车 怎么 刷 骰子	女朋友 被 人 欺负 了 ， 我 该 怎么办 。
入团 申请书 500 字 左右	入团 申请书 600 字	手机 内存 怎样 扩展
谁 看过 一部 很 老 的 电视剧 ，	求 一首 很 老 日本 歌曲	我 想 知道 哪个 牌子 的 脱毛膏 好
求 这个 情侣 头像 的 另一半 谢谢	求 情侣 头像 另一半 谢谢	光 的 三原色 是 什么 ？
孕妇 能 开车 吗	孕妇 开车 好 吗	杨万里 是 什么 朝代 的 人
属 羊 男 与 属 牛 女 配 吗	龙 男 和 虎 女 配 吗	夏天 吃 什么 水果 能 起到 减肥 的 功效 呢
这 玛瑙 是 真的 吗 ？	这个 玛瑙 是 真的 吗 ？	爱 打篮球 的 男生 喜欢 什么样 的 女生
奥拉 星 圣光 修罗 谁 来 帮 我 打 啊	谁 带 我 打 奥拉 星 圣光 修罗 伙伴 试练	点击 【 查看 】 后 ， 页面 会 显示 该笔 退款 的 详情 ， 退款 去向 ， 退回 时间 等 ， 请 关注 。
这 是 哪个 牌子 口红	这 是 什么 牌子 的 口红	什么样 的 人 ， 才 是 帅哥
孕妇 梦见 油炸 粽子 是 什么 意思	孕妇 梦见 好多 粽子 是 什么 意思 ？	梦见 穿 别人 衣服
男 包 什么 牌子 好 呢	男 包 什么 牌子 好	这 是 什么 蔬菜 呀 ？
生理期 能 洗头 吗	月经期 能 喝咖啡 吗	手机 银行 农业银行 转账 到 建行 要 多久
四川 麻酱 麻辣 面 配方	四川 麻辣 面	正月十五 是 什么 时候
补血 女人 吃 什么	女人 吃 什么 补血 呀 ？	如何 修改 陌 陌 绑定 手机号
如果 男人 没有 生育能力 ， 有 什么 证 状	男人 有没有 生育 一胎 后 就 没有 生育能力 的 ?	兔子 尾巴 的 歇后语
汽车 改装 大 包围 如何 审 车 ？	汽车 加装 包围 更改 外观 算是 非法 改装 吗	我 要 找 一个 人
麻烦 您 按照 小 二 给 您 的 建议 操作 下 的 ， 遇到 什么 疑问 可以 随时 与 我 沟通 的 。	麻烦 您 详细 说 下 问题 好 么 。 小 二 才能 快速 帮 您 查询 ， 也 能 为 您 省 下 许多 时间 呢 。	吃 肉 后 身上 肌肉 疼 怎么回事
什么 好看 的 电影 推荐 一下	有 什么 好看 的 电影 推荐 一下	这 是 什么 小 昆虫 ？
求 魔法 少女 イ ス カ 种子	求 か な で 雪 音 表情 包 全套 嗷 。	北京烤鸭 哪里 好吃 ？
这 是 什么 牌子 的 书包 ？	这 是 什么 牌子 的 书包	情侣 头像 黑白 类
我 的 家 作文 开头 怎么 写 ？	《 玩 》 的 作文 开头 怎么 写 ？	手机 通讯录 如何 备份 ?
东张西望 是 什么 意思 ？	东张西望 的 张 是 什么 意思	理科 女生 学 什么 专业 比较 适合
这个 点击 【 有 问题 点 我 】 联系 我们 在线 客服 的 。	不 客气 的 ， 保持 手机 畅通 ， 等待 电话 联系 您	为什么 老公 天天 碰 我
北京 车 在 外地 违章 怎么办 ？	肯德基 网上 订餐 等 了 很 久 怎么 查 啊	天天 爱 猜 图 猜 男明星 范 姓 打头 的 三个 字 的 名星
求 这个 图片 里 的 动漫 人物 名 、	这个 动漫 女生 叫 什么 【 有 图片 】	如何 给 科技 公司 起名 ？
面粉 和 鸡蛋 可以 做 什么	鸡蛋 和 面粉 能 做 什么	这 是 个 什么 发型 ？ 名字 叫 什么 ？
怎么 可以 删除 炫 舞 人物 ？	在 炫 舞 可以 删除 人物 吗	血常规 能 检查 出 乙肝 吗
饱经风霜 的 饱 是 什么 意思	饱经风霜 是 什么 意思 啊	内向 的 人 怎么 学会 与 别人 沟通 和 交流
中国 什么 时候 收复 台湾	中国 什么 时候 可以 收复 台湾	有 哪些 好听 的 儿童 歌曲 ？
新 封神榜 下部	封神榜 下部 出 了 没	直销 和 传销 的 区别 ？
兔子 是 什么 意思	说 别人 是 兔子 ， 是 什么 意思 ？	谁 知道 这 条 裤子 是 什么 牌子 的 啊
同桌 的 你 能 去 哪里 下载 ？	同桌 的 你 在 哪里 下载	女朋友 不 高兴 了 怎么 哄 她 开心 。
生 菠萝蜜 怎么 吃	菠萝蜜 的 核 怎么 吃 ？	呼啦圈 怎么 转 ？
邓丽君 的 歌曲	邓丽君 快 歌曲 有 哪些	穿越 火线 的 挂 怎么 下载
人 为什么 喜欢 欺负 人 ？	人 为什么 喜欢 接吻 ？	在 外贸公司 做 会计 好 还是 房地产 作 会计 好 ？
手机 内存卡 怎么 修复	怎么 修复 手机 内存卡 ？	辛苦 您 换 个 时间段 拨打 一下 ， 辛苦 您 了 。
腾讯 财 付 通 支付 密码 忘记 了 怎么办 ？	易 付 宝 支付 密码 忘记 了 怎么办 ？ 0591 - 88581898	大学生 就业 什么 专业 好找 工作
如果 不是 您 自己 的 账户 ， 您 可以 先 操作 一下 申诉 的	如果 不是 您 自己 的 账户 的话 ， 您 可以 操作 一下 申诉 的	哪个 牌子 的 鼠标 键盘 玩游戏 好
兼职 是 什么 意思	兼职 是 什么 意思 ？	女人 肾虚 吃 什么 好
梦幻 西游 哪个 职业 最 赚钱	梦幻 西游 可以 赚钱 吗 ？	请问 这 是 什么 衣服 ？ 什么 材质 ？
怎样 防止 衣服 缩水 呢 ?	怎样 防止 衣服 缩水	世界 十大 淡水鱼 叫 什么 名
山东 青年 政治 学院 专科专业 分数线	山东 青年 政治 学院 学费	喝 什么 茶 可以 美 白 ？
田亮 是 哪里 人	田亮 是 哪里 人 ？	孕妇 梦见 好多 粽子 是 什么 意思 ？
怎么样 才能 死 啊	怎么样 才能 死 ？	怎样 快速 使 头发 长长
手表 机芯 什么 的 好	手表 都 有 什么 什么 机芯	什么 是 青蛙 的 家
惹 女朋友 生气 了 ， 我 该 怎么办 ？	女朋友 生气 了 ， 我 该 怎么办 呢 ？	网上 都 有 哪些 兼职 可以 做 ， 如何 做
您好 ， 辛苦 您 联系 商户 核实 一下 ， 辛苦 您 了	辛苦 您 查询 一下 您 购买 的 理财产品 合同 上面 会 显示 联系方式 ， 辛苦 您 了 。	郑 大 自考 实践 课 一年 能 考 几次
怎样 使 胡子 不 浓密 ！	怎样 能 让 胡子 长 的 浓密 点	己 的 加 偏旁 组词
怎么 锻炼 自己 的 口才 ？	如何 锻炼 自己 的 口才 ！	兔子 的 动画片
鲁 鲁 修 第三季 什么 时候 出 ？	鲁 鲁 修 第三季 到底 什么 时候 出 啊 ！	微 信 上 怎么 删除 好友
怎么 跟 美女 搭讪 ？	怎么 去 和 美女 搭讪 ？	梦幻 西游 为什么 玩 不了 ？
开 网店 怎么 刷 信誉	网店 如何 刷 信誉	大雪 后 吃 什么 菜
这个 头像 是 情侣 的 吗 ？	谁 有 这个 的 情侣 头像 ？	月经期 能 喝 红酒 吗 ？
邵阳 有 哪些 特产 ？	娄底 的 特产 有 哪些 ？	左 脖子 上 有 痣 代表 什么 女 的
那 您 的 支付宝 是 在 余额 还是 余额 宝 呢	您 是 说 支付宝 余额 还是 余额 宝 呢	麻烦 您 提供 一下 您 接受 短信 的 手机号 ， 辛苦 您 了
谁 知道 这 是 什么 意思 ？	这个 表情 是 什么 意思 ？	含有 反义词 的 成语 。
怎样 画 冰雪 奇缘	求 金牌 网吧 代理 器	这 是 什么 蘑菇 ， 能 不能 吃
灰色 配 什么 颜色 好 ？	藏 灰色 是 什么 颜色 啊	我 的 是 丹凤眼 吗 ？
聚 来 宝 赚钱 是 真的 么 ？	聚 来 宝 是 什么 ？ 真的 能 赚钱 吗 ？	有效 的 瘦 腿 方法 是 什么
南通市 属 哪个 省	南通市 是 在 哪个 省 ？	这种 耳机 怎么 拆
怒之铁拳 怎么 开始	怒之铁拳 怎么 玩	九阳 豆浆机 在 哪里 可以 维修 ？
现在 qq 三国 回归 能 得 什么 东西	QQ 三国 开 商行 要 什么 东西	天天 酷 跑 怎样 刷 积分 ？
哪位 大神 能 告诉 我 这 是 什么 字体 ？	哪位 大神 可以 告诉 我 这 是 什么 字体 ？	搜 片 神器 下载 了 怎么 不能 用
这 狗 什么 品种	这 狗 的 品种 是 ？	龙 之 牧场 这 是 什么 龙 ？
孕妇 梦见 捡 煤 什么 意思	孕妇 梦见 被 蛇 追 是 什么 意思	海贼王 怎么 看 不了 了
大 东 女鞋 如何 加盟	大 东 女鞋 加盟 怎么样	哪里 可以 下载 我 的 世界 中文版
您 现在 登陆 的 这个 账户 开启 了 这个 手机号码 的 登录名 的	这样 建议您 登陆 新 手机号 支付宝 账户 添加 邮箱 登录名 ， 取消 手机号 登录名 后 使用	求 上海 数字电视 播出 的 一部 电视剧 名字
贴 吧 如何 设置 小尾巴	贴 吧 小尾巴 怎么 设置 ？	学 挖掘机 ， 到底 哪家 强 ？
过年 的 作文 怎么 写	怎么 写 过年 的 作文	怎样 发布 信息 到 网上
哪里 卖 本溪 地图	本溪 地图 哪里 买	为什么 女人 总是 喜欢 欺骗 男人 的 感情 ！
吃 吐司面包 会长 胖 吗 ？	经常 吃 面包 好 吗	说 别人 是 兔子 ， 是 什么 意思 ？
一般 用 什么 软件 看 漫画 ？	大家 都 用 什么 软件 看 漫画	什么 软件 可以 送 流量
手机 如何 连接 电视	怎样 用 手机 连接 电视	杂志社 摄影 照片 投稿
支付宝 2015 年度 账单 是 怎么 算 的	支付宝 年度 账单 ， 通讯 类别 是 指 什么	什么 书 比较 好看 ？
怎么 看 不了 海贼王 了	海贼王 怎么 看 不了 了	现在 看 电影 都 是 有 哪些 号 网站 啊
鲍鱼 怎么 做 好吃 ？	鲍鱼 怎么 做 好吃	粤语 话 怎么 说
这个 网络红人 叫 什么 名字	这 是 个 网络红人 ？ 什么 名字 ？	如何 查询 驾驶证 扣分
帮 我 自己 名字 的 个性 签名 设计 下	我 想 为 自己 的 名字 设计 个性 签名	冬季 奥运会 圣火 采集 仪式 是从 哪一年 开始 的 ？
您好 ， 辛苦 您 提供 一下 您 的 操作 页面 截图 这边 帮 您 核实 一下 的 ， 辛苦 您 了 。	建议您 电脑 端 来访 提供 一下 您 的 截图 ， 这边 核实 一下 的 ， 辛苦 您 了 。	这个 是 什么 品牌 皮带
连笔 签名 设计 。	连笔 签名 设计	很 抱歉 给 您 带来 不便 了 ， 花 呗 业务 目前 仅 邀请 部分 用户 体验 花 呗 服务 。
怎样才能 让 眉毛 快点 长 出来 ？	让 眉毛 最快 长 出来 的 办法	谁 有 幸福 花园 动漫 全集 ？
谁 有 奥拉 星 刷 奥 币 脚本 下载 （ 免费 ）	谁 有 奥拉 星 刷 奥 币 的 脚本	叉叉 助手 天天 飞车 ios 怎么 刷 分
女朋友 被 人 欺负 了 ， 我 该 怎么办 ， 我 要 怎么 安慰 她 .	女朋友 被 人 欺负 了 ， 我 该 怎么办 。	天 猫 盒子 和 小米 盒子 那个 好
业已 是 什么 意思	业已 的 业 是 什么 意思	为什么 男人 女人 要 交配
有 什么 好 的 兼职 可以 做 ？ 怎么 做 呢	网上 都 有 哪些 兼职 可以 做 ， 如何 做	查询 银行卡 余额 怎么 查 ？
中国 特色 礼品 哪儿 定制 比较 好 呢 ？	有 什么 中国 特色 的 礼品 可以 送给 泰国 的 小朋友 ?	胸部 怎样 快速 变 大
什么 大雪	大雪 后 吃 什么 菜	红 米 手机 质量 怎么样 ？
虫草 多少 钱 一斤	牛肉 多少 钱 一斤	女生 头像 不 带 字
我 是 丹凤眼 么	我 的 是 丹凤眼 吗 ？	望远镜 什么 牌子 好
这 是 什么 脸型 ？ 长 得 怎样 ？	什么 脸型 这 是	御 龙 在 天 怎么 得 金子
今年 赵本山 上 春晚 吗 ？	赵本山 今年 还 上 春晚 吗	天 猫 和 淘宝 是 什么 关系 ？
如果 这样 ， 建议您 拨打 一下 商户 服务 热线 0571 - 88158090 。	建议您 拨打 这个 淘宝 消费者 服务 热线 （ 买家 ） 0571 - 88158198	什么样 的 女人 做 老婆 最好 ？
这个 是 什么 播放器 ？	这 是 什么 软件 ？ 是 微 博 吗 ？	亲 辛苦 您 核实 收支 明细 对账 看 一下 的
男人 都 忘不了 初恋 吗 ？	男人 都 忘不了 他 的 初恋 吗 ？	月经期 能 喝咖啡 吗
麻烦 您 提供 接受 短信 的 手机号 ， 辛苦 您 了	麻烦 您 提供 一下 您 接受 短信 的 手机号 ， 辛苦 您 了	陈世美 是 指 什么 生肖
怎么 才能 快速 练 腹肌 ？	怎么 快速 练 腹肌	微 信 如何 截图 聊天记录
窜 骨 高 额头 尖 什么 发型 适合	我 的 额头 窄 ， 适合 什么 发型 呢 ？	怎样 下载 万能钥匙
成人礼 送 男生 什么 礼物 好	送 男生 什么 成人礼 礼物	您 点击 账户 通 - 我 的 银行卡 - 添加 就 可以 的 ， 辛苦 您 了 。
我 的 世界 可以 刷 钻石 吗	我 的 世界 钻石 长 什么样	姐弟恋 好不好
手机 跑 分 是 什么 意思	手机 跑 分 是 什么 意思 啊 ？	都市 异能 小 说完 本 的
怎么 瘦 腿 ？ 求 瘦 腿	怎样 可以 瘦 腿 ？	怎样 下载 完 本 小说
流浪 武士 用 什么 主 武器	dnf 流浪 武士 主 手 用 什么 武器	怎么 快速 练 腹肌
这 钱包 是 什么 牌子 的 ?	CLUCL 是 什么 牌子 包包 。	找 一些 搞笑 的 表情
四川 城市 职业 学院 可以 转 专业 吗 ？	四川 城市 职业 学院 一年 的 学费 是 多少 啊 ？	卡 呼呼 什么 意思
现在 做 什么 职业 最 赚钱 .	现在 做 什么 职业 赚钱 最快	《 打 狗 棍 》 的 主题曲 叫 什么 名字 ？
奔跑 吧 兄弟 大 电影 为什么 没有 邓 超	为什么 奔跑 吧 兄弟 电影 没有 邓 超	这 是 个 网络红人 ？ 什么 名字 ？
弹弹 堂 什么 武器 最好 用 ？	弹弹 堂 什么 武器 最好	百合 什么 意思
重庆 哪家 火锅 最 好吃 ？	重庆 最 好吃 的 火锅 是 哪家	怎样 能 找到 一个 人 ？
请教 一个 高中地理 问题 雪线	请教 一个 高中地理 问题 天气 系统	鲁 鲁 修 第三季 到底 什么 时候 出 啊 ！
任性 是 什么 意思 ？	这么 任性 ？ 什么 意思	梦幻 西游 好玩 吗
为什么 天空 是 蓝色 的 ？	天空 为什么 是 蓝色 的 ？	海参 怎么 吃
红 裤子 配 什么 颜色 的 衣服 好看 ?	红 格子 裤子 配 什么 颜色 衣服 好看	什么 花香 ， 为什么
什么 烟 对 人 危害 最小 ？	什么 烟 对 人 危害 最小	如何 炖 熟 花生 ？
益阳 移动 宽带 好不好 用 ？ 可不可以 玩 问道 ？	移动 高速 宽带 质量 如何 ？ 能 玩游戏 么 ？	中国 的 航母 停 在 那
什么 网络游戏 好玩 ？	有 什么 好玩 的 网络游戏	孕妇 开车 好 吗
青蛙 吃 什么 ？	什么 是 青蛙 的 家	吃 什么 能 增多 头发 ？
亲 ， 您 是 用 什么 付款 方式 的 呢	请问 您 是 什么 方式 支付 的 ？	把 环卫工人 比喻 成 什么 ？
怎么 设置 路由器 限制 网速	路由器 怎么 设置 网速 限制	姓 臧 的 有 什么 名人 ？
亲 ， 我 帮 您 转接 对应 的 工作人员 帮 您 核实 一下 可以 吗	真的 很 抱歉 的 ， 小 二 这边 帮 您 转接 相关 工作人员 帮 您 核实 一下 ， 可以 吗	手机 日语 输入法 下载
在 春天 这个 季节 ， 晚上 几点 睡觉 比较 合适 ？	春天 这个 季节 用 什么 洗发水 比较 好 ？	珊瑚 像 什么 角
有 谁 会 盗号 ？ 求 高手 …	功夫 派 有 什么 辅助 器 ？ ！ 求 啊	电脑 太卡 怎么 解决 ?
什么 东西 是 绿色 的 ？	还有 什么 东西 是 绿色 的 ？	精卫填海 中 的 精卫 指 的 是 什么
挖掘机 学校 哪家 强	挖掘机 学校 哪家 强 。	求 百日 蔷薇 漫画 【 全 】
一片 叶子 有 面膜 吗 ？	一片 叶子 能 做 面膜 吗 ？	人 为什么 喜欢 接吻 ？
什么 牌子 的 牙膏 好	用 什么 牙膏 牌子 好 ？	什么 东西 是 降血压 的
很 抱歉 ， 已经 注册 了 支付宝 账户 的 邮箱 是 不能 再 注册 支付宝 账户 了 的 。	这个 已经 注册 过 支付宝 账户 的 邮箱 无法 再 注册 其他 的 账户 的 ， 很 抱歉 。	西瓜 地里 散步 , 打 一 谚语
男生 起 什么 名字 好听 ？	姓常 的 男生 取 什么 名字 比较 好听	右手 小手指 发麻 已 两天 ， 不知 是 什么 原因
怀孕 可以 做爱 吗 ，	怀孕 了 可以 做爱 吗	怎么 查 别人 的 通话记录
我们 鸟儿 会 飞	鸟儿 为啥 会 飞	中学生 怎么 减肥
阐 幽 护肤品 怎么样 ， 有 谁 用 过 说 说	阐 幽 护肤品 怎么样 ， 有 谁 用 过	湖南 的 特产 是 什么
红 米 手机 质量 怎么样	红 米 手机 质量 怎么样 ？	玩 跑跑 卡丁车 大家 都 说 我 卡
爱情 里 没有 谁错 谁 对 …	爱情 里 没有 谁 对 谁错 吗 ？	上海 大宁 灵石 公园 晚上 几点 关门 啊 ？
每天 吃饭 ， 睡觉 ， 打 豆豆 是 什么 意思 呀	吃饭 睡觉 打 豆豆 、 是 什么 意思	养 什么 鱼 不 容易 死 ？
我 适合 空气 刘海 吗 ？ 我 是 什么 脸型	有 什么 好看 的 发型 。 ( 男生 的 )	这个 人物 出自 哪部 动漫
什么 是 女 干部	当 干部 为了 什么	驾驶证 违章 扣分 怎么 查询 ？
怎么 更新 天天 酷 跑	天天 酷 跑 怎么 更新 ？	祚 的 连笔 字 怎么 写 才 好看
孕妇 梦见 鸟 是 什么 意思 ？	孕妇 梦见 买 蜡 什么 意思	江苏 技术 师范学院 的 住宿 情况 怎么样 啊 ?
有 什么 姓 骆 的 名人 ？	姓 臧 的 有 什么 名人 ？	DNF 公会 升级 怎么 不 送 东西
汽车 脚 刹车 怎么 调	汽车 刹车 线 怎么 调	天天 酷 跑 怎么 抽 到 舞狮 闹 闹
天天 酷 跑 谁 送 我 精灵	谁 送 我 天天 酷 跑 钻石 礼包	你 是 学生 ？ 呵呵 ！
很 抱歉 ， 未 核实 到 您 ８ 月 ９ 日 有 ５ ０ ０ 的 充值 的 ， 只有 ５ ０ ０ ０ 的 亲 。	您好 　 ２ ０ １ ３ 年 ２ . １ ７ － ２ . ２ ２ 日 　 没有 ３ １ ３ １ 　 的 交易 金额 。	怎样 在 百度 上 发帖
宝宝 拉肚子 能 打预防针 吗 为什么	宝宝 拉肚子 可以 打预防针 吗 ？	老人 本命年 送 什么
怎么 扎 马尾辫 好看	马尾辫 怎么 梳 好看	网店 如何 刷 信誉
城郊 开挖 专供 钓鱼 的 鱼塘 ， 这个 投资 能 赚钱 吗 ？	魔兽 世界 钓鱼 和 烹饪 有用吗 ？ 能 赚钱 吗 ？	炒 黄金 能 赚钱 吗 ？
什么 东西 对 减肥 有 效果	什么 东西 减肥 效果 快	睾丸炎 看 什么 科 ？
求 《 紫 御 璃 天 》 全文	求 《 龙 族 》 里 描写 人物 的 句子	在 微 信 群 , 如何 请 其他人 加入 群 。
仔细 的 近 反义词 是 什么	！ 仔细 的 反义词 是 什么	这个 图片 的 成语
为什么 我 的 身份证 被 禁用	为什么 身份证 会 被 禁用 ？	这 是 哪部 电视剧 里 的
为什么 喜欢 我 的 人 都 是 我 的 同桌 呢	我 爱 一个 人 ， 如何 让 他 爱 上 我	帮忙 起 个 店名 吧 ～
几 一声 怎么 组词	据 的 一声 怎样 组词	什么 牌子 的 熨斗 最好 呢 ？
家装 壁纸 和 乳胶漆 哪个 更 环保	壁纸 和 家 乳胶漆 哪个 环保	神雕侠侣 什么 时候 播
怎么 晒 萝卜丝	红 萝卜丝 怎么 炒	读书 万卷 他 不厌 【 解 生肖 】
中国 知 网 怎样 免费 下载 论文	如何 免费 下载 中国 知 网 论文	疯狂 猜 明星 小时候 他 是 谁
大家 觉得 第三次 世界大战 啥时候 会 爆发 呢 ？	世界 第三次 世界大战 爆发 ， 有 这种 可能 吗 ？	谁 有 黄 的 小说 ， 要 很 黄 很 暴力 的
请问 图片 中 的 植物 是 什么 ？	请问 图片 上 的 这个 植物 叫 什么 ？	有钱 没 钱 回家 过年 谁 唱 的
怎么 使 鼻子 变 高 ？	怎么 才能 让 鼻子 变 高	今天 24 点 之前 到 账 的 具体 到 账 时间 以 页面 显示 的 为准 的 麻烦 了
云南 有 什么 好 茶	云南 普洱茶 哪个 牌子 好	人 的 精子 是 什么 样子
您 的 那个 账户 是否 还有 其他 的 信息 ， 比如 绑定 的 手机号码 ， 淘宝 账户 ， 银行卡 等 ？	一个 手机号 是 可以 绑定 在 6 个 支付宝 账户 中 的 ， 都 是 没有 任何 影响 的	剑灵 天 族 剑士 副 职业 选 什么 好
香菜 孕妇 可以 吃 吗	孕妇 能 吃 浑 香菜 吗	求 这 张 照片 原图
大象 的 鼻子 相 什么	大象 的 鼻子 像 什么	从 电脑 上 怎么 给 一个 手机号码 发短信 ？
蒙古语 “ 塔拉 日 哈 啦 ” 什么 意思 ?	“ 安达 ” 蒙古语 是 什么 意思	哪个 牌子 的 电水壶 好
怎么 喂食 宠物	宠物 怎么 喂食	您好 ， 您 还是 访客 状态 呢
北京站 在 哪个 区	北京站 是 哪个 区	结婚 穿 什么 衣服
湖南 科技 大学 转 专业	湖南 科技 大学 热门 专业	翘翘板 ( 打 一 成语 )
这 是 什么 鸟 ， 叫 什么 名字 啊	这 是 什么 花 ？ 名字 ， 怎么 养 ？	您 截图 4 月 6 号 到 4 月 8 号 的 收支 明细 给 我 ，
女孩子 最 喜欢 听 什么 话 呢	女孩子 不 喜欢 什么 ？	买 什么 牌子 冰箱 最好 ？
苹果 5 的 手机 怎么 免费 下载 游戏	苹果 手机 怎么 下载 游戏	追女孩 要 怎么 追
您好 ， 注销 主 账户 是 需要 先 注销 子 账户 的	很 抱歉 ， 如果 要 注销 主 账户 ， 是 需要 先 注销 子 账户 的 。	求 藏头诗 ： 我 爱 吴 琼
什么 方法 能 解酒	解酒 方法 喝 什么 水	打雷 对 电脑 有 影响 么 ，
身上 长 廯 怎么 治	鸟 屎 掉 在 身上 会 怎么样 ？	娄底 的 特产 有 哪些 ？
脚趾 发麻 是 怎么回事	脚趾 发麻 怎么回事	怎么 叠 小船
爸爸 去 哪儿 多多 贝 儿	爸爸 去 哪儿 贝 儿 贱	为什么 向日葵 向着 太阳 转
助听器 什么 牌子 的 好 ?	国产 助听器 什么 牌子 最好	面膜 有 那些 品牌 好
脸上 雀斑 怎么 去除	怎样 去除 脸上 的 雀斑 ？	侠盗 飞车 修改器 罪恶都市
什么 电视剧 好看 。 推荐 一下	有 什么 好看 的 电视剧 ， 推荐 一下	金 巴利 陶瓷 怎么样 ？
贵族 天籁 纸鸢 完结	贵族 完结 天籁 纸鸢	小孩子 喜欢 吃 什么 菜
最近 有 什么 新闻 吗 ？	最近 的 新闻 是 什么 ？	信 和 财富 理财 好不好 ？ 有没有 风险
为什么 兔子 喜欢 吃 萝卜 ？	兔子 为什么 喜欢 吃 萝卜	全世界 最 漂亮 最 贵 的 车 是 什么 车
南京 盐水鸭 好吃 吗	南京 盐水鸭 好吃 吗 ？	残阳 什么 意思
如何 养 兔子 交配	兔子 怎样 交配 ？	北京 海淀区 有 股票 开户 的 地方 吗 ？
刘 诗 诗 为什么 喜欢 吴奇隆 ？	刘 诗 诗 喜欢 吴奇隆 吗 ？	矫情 是 什么 意思 啊 ？
茄子 怎么 做 咸菜	茄子 咸菜 如何 做	这 句 日语 怎么 说 啊 ？
谁知 这 是 哪个 国家	这 是 哪个 国家 钱	我 表哥 ， 堂哥 的 儿子 或 女儿 叫 我 什么 ？
收藏 人民币 有 价值 吗 ？ 收藏 那 一套 好 呢 ？	流通 过 的 人民币 还有 价值 吗 ? 能 不能 收藏 ?	热水器 用 什么 牌子 好
非常 抱歉 给 您 添麻烦 了 ， 取消 账户 是 需要 账户 信息 本人 操作 的 ，	很 抱歉 ， 建议您 使用 本人 的 身份 信息 操作 注册 账户	奔跑 吧 兄弟 主题曲 ！
怎样 可以 让 头发 快速 长长 ？	怎样 快速 使 头发 长长	伦敦 奥运会 金牌 是 纯金 的 吗 ？
新年 最好 的 祝福语 有 哪些 ？	有 哪些 时尚 的 新年 祝福语	显卡 是 什么 东西
七夕 情人节 送 什么 给 女朋友 好 呢	七夕 情人节 送 女朋友 什么 好	甘肃 建筑 职业 技术 学院 2015 年 新生 啥时候 军训
酒精肝 吃 什么 好	酒精肝 吃 什么 药	排毒 什么 产品 好
这 是 什么 蘑菇 ？ 能 不能 吃 ？	这 是 什么 蘑菇 ， 能 不能 吃	什么 牌子 的 电视 盒子 好
含 正是 不是 上海市委 书记	上海市委 书记 是	您 是 说 支付宝 余额 还是 余额 宝 呢
广州 哪里 有 小吃街 ？	广州 哪里 有 小吃街	求 范冰冰 苹果 完整版 ？ 谁 有
今天 我 吃 没 吃晚饭 ？	你 今天 · 吃晚饭 了 么 ？	骂人 的话 ， 越 毒 越 好
母亲节 是 什么 时候	母亲节 什么 时候 到	求 一条 阿迪达斯 三叶草 运动 休闲裤
这个 季节 去 哪里 游玩 好玩 ？	这个 季节 去 哪里 好玩 ？	哈 奇 小镇 祖 玛 为啥 我 玩 通关 了 也 不 给 我 金橘 种子 ？
现在 这个 季节 哪里 好玩 一点 ？	这个 季节 西安 哪里 好玩 ？	时间 都 去 哪儿 了 是 谁 唱 的 ？
求 富贵 论坛 邀请 码 ！	能 给 我 一个 仙 珍 园 邀请 码 吗 谢谢 了	去 香港 买 什么 药 划算
高 额头 适合 留 刘海 吗 ？	我 额头 窄 ， 适合 什么 刘海 ？	哪里 能 买 到 草莓 苗
解梦 ， 梦见 火	解梦 梦见 狗 咬 死 狗	哪个 网站 可以 看 电影 操 我
这 狗 的 品种 是 ？	这 狗 是 啥 品种 的 ？	怎么 删除 自己 发 的 提问
怎么样 分别 苹果 手机 是 哪里 产 的	苹果 手机 是 那个 国家 生产 的 ？	如果 没有 其他 问题 的话 ， 那 这边 就 先 不 打扰 您 了 。 预祝 周末 愉快 哦 ~
玉米粒 怎么 做 好吃	玉米粒 怎么 做 好吃 ？	如何 去除 脸上 的 斑
你 是 学生 吗	你 是 学生 ？ 呵呵 ！	什么 鬼片 好看
天龙八部 问题	新 天龙八部 问题	黑 嘟嘟 是 什么 意思
具体 您 买 的 是 什么 产品 的 吗	您 买 的 是 什么 产品 的 呢	怎样 跑步 又 快 又 不 累
摄影 作品 投稿 要求	杂志社 摄影 照片 投稿	萌 头像 的 软件 是 什么
求 优 酷 会员帐号 共享 。	求 优 酷 会员帐号 共享	推荐 部 电视剧
北京 奥运会 鬼 的 金牌 是 纯金 的 吗 ?	伦敦 奥运会 金牌 是 纯金 的 吗 ？	什么 牌子 的 苹果醋 好 ？
株洲 交通银行 的 客服 电话 是 多少	交通银行 信用卡 的 人工 号码 是 多少 啊	这 是 什么 软件 ？ 是 微 博 吗 ？
求 音乐 ： 三国 杀 虎牢关	求 三国 杀 虎牢关 音乐	哪里 充 话费 最 便宜
这 酒 多少 钱 一瓶 啊	这 酒 多 钱 一瓶 ？	头晕 胸闷 犯 恶心 是 什么 病
古 剑 奇谭 过 狼 妖 的 存档	古 剑 奇谭 去 幽 都 存档	想 给 自己 起 一个 好听 的 微 信 名
《 我 想 我 不够 好 》 伴奏	求 音乐 ： 爱 我 就 亲 我 吧	福州 那里 有 旧 照片 翻新 ？
请问 大家 这 是 什么 手镯 ？ 什么 材质 的 ？	请问 这 是 什么 衣服 ？ 什么 材质 ？	洛克 王国 的 冰 龙 宝宝 是 什么 组 的
梦见 别人 穿 新 衣服	梦见 穿 别人 衣服	汞 是 由 汞 分子 组成 的 对 吗
求 一部 印度 电影 名字 ！	求 一部 老 电视剧 ( 古装 )	元宝 是 怎么 叠 的
这种 耳机 怎么 戴 ？	这种 耳机 怎么 拆	怎么 破解 迅雷 会员
酷 狗 音乐 下载	我 想 下载 酷 狗 音乐	起 凡 怎么 冲 通宝
怎么 把 自己 照片 变成 漫画	照片 怎么 变成 漫画	苹果 手机 如何 下载 铃声
止咳 糖浆 的 牌子 有 哪些	止咳 糖浆 哪个 牌子 好	易语言 进度条 。
燕子 窝 怎么 做	怎么 画 燕子	这 狗 的 品种 是 ？
两 涘 渚 崖 之间 的 之 是 什么 意思	虹 之间 什么 意思 ？	有 这 张 图片 的 高清 大 图 吗
玩 飞机 杯 有 什么 感觉 ？	飞机 杯 用来 是 什么 感觉 怎么 用	如何 让 戚 风 蛋糕 不 回 缩
三星 手机 i9100G 新浪 天气 怎么 下载	三星 7562 手机 怎么 下载 新浪 天气 小组 插件	爱 喝酒 的 老公 我 该 怎么办
全民 枪战 怎么 飞 了	全民 枪战 的 人 怎么 飞	中国 有 多少 叫 毛泽东
那么 问题 来 了 ？	那么 问题 来 了 ！	很 要 好 的 女生 叫 我 爸爸 … 这 是 什么 意思 ？
武财神 是 谁 啊	武财神 是 谁	浙江 有 什么 好玩 的 地方 ？
好看 的 都市生活 小说 推荐	写 网游 的 小说 ！ 来 几部 吗 ？	蔡康永 的 说话 之 道
单身 的 情人节 怎么 过 ？	单身 情人节 你们 怎么 过 ？	给 我 这个 兔子 起 名字
四年级 英语单词	用 四年级 的 英语单词	岑 参 是 哪个 朝代 的
虎 求 百兽 而 食 之 的 食 是 什么 意思	虎 求 百兽 而 食 之 ， 得 狐 。 意思 是 什么	爸爸 去 哪儿 第三季
英雄 联盟 电信 一 区 是 哪个 ？	英雄 联盟 电信 一 区 是 哪个 区 ？	新浪 微 博 怎么 删除 啊
这 妹子 是 谁 ， 哪个 动漫 ？	谁 知道 这 妹子 是 哪部 动漫 的	今年过年 流行 什么 衣服 呢
爱情 雨 夏 娜 用 的 手机 铃声	爱情 雨 夏 娜 的 手机 铃声	微 信 上 怎么 买 东西
中文 叫 什么 名字	绫 瀬 は る な 这个 名字 中文 是 什么	大象 的 鼻子 像 什么
六年级 上册 习作 六	六年级 上册 习作 一	摩托车 机 什么 什么 牌子 最好
梦见 别人 开车 走 了	梦见 开车 压 在 牛 屎 上	有关 文明礼仪 的 手抄报
求 重生 娱乐圈 的 耽 美文	求 重生 娱乐圈 耽 美文	老 男孩 的 电影 哪里 有 啊
我 的 世界 哪个 是 种子 代码	我 的 世界 的 种子 代码 是 什么 ？	爱情 回来 了 电视剧
这种 围巾 是 什么 织法	这种 围巾 怎么 织 什么 织法	dnf 流浪 武士 主 手 用 什么 武器
女士 吸 的 烟 都 有 什么 牌子 ？	国产 女士 香烟 都 有 什么 牌子 ？	用 四年级 的 英语单词
三星 手机 相册 打不开	华为 手机 相机 相册 一直 闪 打不开	鲸鱼 搁浅 为什么 舌头 会 吹 泼
非主流 搜狗 皮肤 从 哪里 下载	从 搜狗 盒子 里 下载 来 的 皮肤 在 哪里	求 推荐 动漫 ！
目前 您 的 账户 存在 风险 需要 修改 登录 密码 和 支付 密码 的	您 的 账户 存在 风险 ， 需要 您 修改 登录 密码 和 支付 密码 的	我 姓 龙 我心 什么
求 这个 头像 高清 大 图	求 头像 ， 高清 大 图	中国 哪个 地方 钱 最好 赚
什么 是 黄金 股	什么 黄金 好	微 淘 什么 意思
怎样 给 身体 排毒 ？	怎么 让 身体 排毒 ？	韩国 哪些 护肤品 好
如何 提取 图片 中 的 文字 ？	如何 制作 闪 字 图片 ？	新疆 特产 是 什么 ？
炒 黄金 赚钱 吗	炒 黄金 能 赚钱 吗 ？	菠萝蜜 的 核 怎么 吃 ？
这种 头发 的 颜色 是 什么 色	这种 头发 的 颜色 是 什么 ？	什么 手机游戏 和 英雄 联盟 一样
好 男人 的 标准	好 男人 的 标准 是 ，	小学生 如何 做 教师节 贺卡
我 的 世界 怎么 造 房子 ？	我 的 世界 怎么 建 房子 ？	购房 合同 公积金 贷款
王 源 喜欢 谁 ？	李 敏 镐 ， 金 秀 贤 ， 你们 喜欢 谁	这里 是 广西 的 哪里 ？
理科 女生 适合 学 什么 专业	理科 女生 学 什么 专业 比较 适合	喜事 连连 是 什么 生肖 ？
我 的 世界 怎么 灭 岩浆 流	我 的 世界 怎么 药 岩浆	麻烦 您 提供 一下 您 接受 短信 的 手机号 ， 辛苦 您 了
南 珊瑚 是 什么	珊瑚 像 什么 角	怎么 做 聊天 机器人
如何 才能 告别 单身	如何 才能 告别 单身 ？	电影 《 不能 说 的 秘密 》
报考 食品科学 与 工程 的 研究生	食品科学 与 工程 出国 读 研究生	微 信 头像 如何 设置
吃 什么 有助于 伤口 的 愈合	吃 什么 食品 有助于 伤口 愈合	求 《 龙 族 》 里 描写 人物 的 句子
为什么 今天 下雨 ？	今天 下雨 了	汽车 刹车 线 怎么 调
女生 打 那 只 耳朵 的 耳洞 吗 ？	女生 打 耳洞 在 那 只 耳朵 吗 ？	下载 单机游戏 哪个 网站 好
怎么 做 芝麻 鸡 ？	香辣 鸡 怎么 做 ？	怎样 快速 写 完 作业 ？
麻烦 您 电脑 来访 提供 截图 来 咨询 我们 核实	电脑 端 联系 我们 一下 ， 把 页面 截图 提供 给 我们	脸上 痘痘 怎么 消除
最好 用 的 导航 是 什么	什么 导航 最好 用	财神 送来 四 五六 猜 一 生肖
剑灵 刺客 选 什么 副 职业 好	剑灵 天 族 剑士 副 职业 选 什么 好	广州 搬家 公司 哪家 便宜
怎么 把 淘宝 和 支付宝 绑定	如何 开通 支付宝 和 财 付 通 呢	的 说 日语 什么 意思 哇 咔 咔 擦
尾号 4 位 是 多少 呢	尾号 4 位 多少	灰 太 狼 的 梦想 是 什么
我 的 配置 玩游戏 怎么样	这 配置 玩游戏 怎么样 ？	郑州 哪里 有 女 包 批发 ？
良药苦口利于病 ， 前 一句	良药苦口利于病 的 上 一句	情人节 女生 送 男生 礼物 吗
铠甲 勇士 之 帝皇 侠 哪里 有	谁 有 铠甲 勇士 之 帝皇 侠	谁 发明 了 电灯
过氧化钠 的 电子式 怎么 写 ?	过氧化钠 的 电子式 怎么 写 ？	八年级 下册 数学 。
日语 这 句 话 怎么 说 !	这 句 话 日语 怎么 说 呢 ？	新生儿 吃 什么 奶粉 好 _ 百度 拇指 医生
窥 的 形 近 字 急急 急	颧 的 形 近 字 , 急急 急	求 吴 亦 凡 滴 照片 ！
梦见 我 捡 了 好多 的 死 鱼 和 笼 虾	周 公 解梦 梦见 蛇 ， 吃 蛇 蛋 怎么办 ？	古 剑 奇谭 去 幽 都 存档
我 妹妹 漂亮 吗 ？	这个 妹妹 漂亮 吗 ？	淘宝 拍卖 保证金
麻烦 您 提供 一下 页面 报错 的 截图 ， 辛苦 您 了	麻烦 您 提供 一下 报错 的 页面 截图 ， 辛苦 您 了	工业 酒精 哪里 有 卖
谁 有 什么 好 工作 介绍 介绍	谁 有 什么 好 工作 给 我 介绍 一下	求 视频 里 的 歌曲 名字 叫 什么
陌 陌 怎么 修改 绑定 手机号	如何 修改 陌 陌 绑定 手机号	尼玛 啊 是 什么 意思 ？
这 是 哪部 电影 或 电视剧 啊 ？	这 是 哪部 电影 还是 电视剧 里 的	今天 晚上 吃 什么 饭 ？
衰弱 的 反义词 是 什么 ？	衰弱 的 反义词 是 什么	手机 怎么 才能 打出 特殊符号
黄鹤楼 在 哪里	疯狂 英语 杂志 哪里 买	成龙 最新 电影 是 什么
男人 什么 情况 下 容易 出轨	男人 在 什么 情况 下 容易 有情人 或 做 出轨 的 事情 呢	尾号 是 多少 后 4 位
怎样 在 微 信 上 分享 链接	微 信 怎样 分享 链接	现在 做 什么 职业 赚钱 最快
郑州大学 自考 市场营销 何时 报名 ？	郑 大 自考 实践 课 一年 能 考 几次	如何 把 带 无线 的 电脑 连接 到 打印机 上
羊奶粉 什么 牌子 的 比较 好	喝 什么 牌子 的 羊奶粉 好 呢	奥比 岛 怎样 能 让 小精灵 升级 形态
怎么 才能 让 胡子 长 得 慢点 ？ 。	怎么 让 胡子 长 得 慢点	天牛 吃 什么 啊 在 哪 找 啊
七夕节 怎么 过 浪漫 ，	怎么 做 聊天 机器人	怎样 让 头发 蓬松 ？
第一次 去 男朋友 见 家长 该 怎么 做 ？	第一次 去 男朋友 家 见 家长 ， 该 怎么 做 ， 很 紧张	石家庄 有 什么 好玩 的 地方
想 做 韩 束 代理 怎么 做	韩 束 怎么 做 代理	求 本 关于 狐 妖 的 小说
您好 您 的 银行卡 扣款 明细 麻烦 您 再 提供 一下	亲 辛苦 您 核实 收支 明细 对账 看 一下 的	安徽 过年 习俗
建议您 换 个 时间 更换 浏览器 再 操作 一下 的 ， 辛苦 了 。	建议您 换 个 浏览器 试 下 ， 如果 还是 不行 的话 ， 建议您 电脑 端 操作 下 ， 辛苦 您 了	这个 图片 出自 哪部 动漫
怎么 在 网上 充 话费	网上 交 话费 怎么 交	求 音乐 ： 情 锁 陈 思 安 伴奏
木瓜 里 的 籽 能 吃 吗 ？	木瓜 的 籽 能 吃 吗 ？	如何 扩大 自己 社交圈 ？
什么 时候 是 尾牙 啊 ？	尾牙 宴 从 什么 时候 开始	请 帮 我 取 一个 服装店 名 ， 要 好听 的
求 动漫 触手	求 欧美 动漫	怎样 鼻子 才能 变 高
什么 牌子 的 奶粉 适合 新生儿 喝	新生儿 吃 什么 奶粉 好 _ 百度 拇指 医生	帮忙 取 个 名字 ，
迅雷 会员 分享	分享 迅雷 会员	人们 常 把 记者 比喻 成 什么
推荐 一部 好看 的 电视剧 。	大家 给 推荐 一部 好看 的 电视剧	从 搜狗 盒子 里 下载 来 的 皮肤 在 哪里
贝尔 发明 什么	贝尔 发明 了 什么 ？	怎么 识别 苹果 手机 真假
小学生 用 什么 牌子 的 台灯 比较 好 呢	什么 牌子 的 台灯 孩子 用 好	这 幅 图片 的 寓意 是 什么
农业银行 密码 怎么 改	暖 暖 忘记 密码	毛血旺 是 哪个 地方 的 菜
你们 喜欢 的 一句 话 是 什么	你 最 喜欢 的 一句 话 是 什么 ？	云南 机电 职业 技术 学院 2016 有没有 自主 招生
肾阳虚 吃 什么 药 好	脾 肾阳虚 吃 什么 药 好	什么 运动 减肥 最 有 有效
微 信 商店 怎么 买 东西	微 信 上 怎么 买 东西	现在 玩 什么游戏 能 赚钱 ？
今年 最 流行 的 是 什么 颜色 的 头发	今年 头发 什么 颜色 最 流行 ？	颧 的 形 近 字 , 急急 急
什么 星座 的 人 最 受欢迎 ？	什么 星座 的 人 最 不 受欢迎 ?	辛苦 您 等待 下 的 ， 辛苦 您 了 。
微 信 在 哪 看 别人 的 朋友圈	关于 微 信 朋友圈	这样 的 额头 算 饱满 吗
摩尔 庄园 超级 拉姆	摩尔 庄园 东部 游乐场	怎样 让 胡子 长 得 浓密 点 ！
哪个 品牌 的 电 灭蚊灯 好	灭蚊灯 哪个 品牌 好	求 鼠 猫 同 人文 谢 啦
孕妇 补锌 吃 什么 好	孕妇 补锌 ， 吃 什么 好 ？	高富帅 、 白 富 美 标准 是 什么 ？
斗地主 有 什么 技巧	斗地主 有 什么 技巧 ？	颈椎病 怎么 治 ？
看 图 猜 明星 她 是 谁 啊	疯狂 猜 明星 小时候 他 是 谁	求 金牌 网吧 代理 器
您好 。 请问 您 的 这个 电脑 是 什么 系统 的 ， 浏览器 是 哪个 ？	您好 ， 我 这边 查询 到 您 的 支付宝 账户 是 没有 问题 的 ， 您 有没有 换 浏览器 试一下 呢 ？	推荐 几本 好书
小学生 怎样 做 教师节 贺卡	小学生 如何 做 教师节 贺卡	怎样 用 手机 连接 电视
中国 南 车 这个 股票 怎样 ？	中国 南 车 股票 怎样 ？	怎么 洗澡 又 快 又 干净
淘宝 上 买 东西 便宜 点 吗 ？ 可信 吗 ？	淘宝网 上 买 的 东西 可靠 吗 ？ 东西 质量 怎样 ？	孕妇 梦见 被 蛇 追 是 什么 意思
怎么 修改 淘宝 的 用户名 ？	淘宝 的 用户名 怎样 修改	怎么 开通 流量 加油 包 。
香肠 的 意思 是 什么 ？	香肠 腿 什么 意思	这个 主持人 人 叫 什么 名字 ？
油性 头发 用 什么 洗发水 好	油性 头发 用 什么 洗发水 比较 好	不是 一个月 还 完 的
淘宝 上 买 茶叶 ， 怎么样 ？	淘宝 代购 怎么样 ？ 是 正品 吗 ？	在 新加坡 玩 街头 篮球 ， 找 哪个 代理 好 啊 ， 愁 死 了 啊
膜法 传奇 面膜 如何 ？	膜法 传奇 面膜 怎么样	谁 为 我 起 个 网名
孕妇 梦见 自己 床头 边 站 着 一个 小女孩	孕妇 做梦 梦见 自己 生 了 一个 头戴 王冠 的 小女孩	明天 上海 天气 怎么样 。
这种 刘海 怎么弄	这种 刘海 怎么弄 呢	求 情侣 头像 另一半 谢谢
你 对 我 一见钟情 是 什么 意思	说 说 你 现在 ， 是 做 什么 工作	国内 现在 瑜伽 垫 品质 哪个 品牌 最好 用
怎么 取消 支付宝 实名 认证	如何 取消 支付宝 实名 认证 ？	电脑 有 什么 软件 可以 赚钱
这 是 什么 动漫 ？ 游戏 ？	这 是 什么 动漫 还是 游戏	中兴 手机 质量 怎么样 ？
四川 商务 职业 学院 好不好 ?	四川 商务 职业 学院 好不好 呀	哪位 大神 可以 告诉 我 这 是 什么 字体 ？
怎么 登陆 支付宝	怎样 登陆 支付宝	怎么 在 电脑 上 录像
三年级 的 英语单词	什么 看 什么 视 三年级 语文 提	一个 手机号 是 可以 绑定 在 6 个 支付宝 账户 中 的 ， 都 是 没有 任何 影响 的
世界 三 大 禁 曲	关于 世界 三 大 禁 曲	电脑 端 联系 我们 一下 ， 把 页面 截图 提供 给 我们
小孩子 为什么 喜欢 吃糖	为什么 小孩子 喜欢 吃糖 呢 ？	么 么 哒 之类 词语
什么 车标 ？	三 把 刀 车标 叫 什么 车	关于 微 信 朋友圈
这 是 哪部 电视剧	这 是 哪部 电视剧 里 的	世界 上 什么 动物 速度 最快
欧莱雅 护肤品 怎么样	欧莱雅 护肤品 怎样	联合国 现任 副 秘书长
派出所 和 公安局 有 什么 区别	公安局 与 派出所 的 区别 是 什么 ？	谁 有 好看 的 手机 壁纸
抱歉 ， 如果 您 上传 完 了 的话 ， 这次 是 会 通过 的 呢	如果 没有 其他 问题 的话 ， 那 这边 就 先 不 打扰 您 了 。 预祝 周末 愉快 哦 ~	蘑菇 街 是 货到付款 吗
侠盗 飞车 怎么 下 飞机	侠盗 飞车 怎么 开 飞机	求 海绵 宝宝 图片
建议您 卸载 支付宝 钱包 ， 重新安装 试一下	建议您 卸载 支付宝 钱包 重新安装 试 下 的	微 信 语音 存储 一段时间 就 没 声音
自由自在 什么 歌	自由自在 是 什么 然	酒精肝 吃 什么 药
太阳 是 什么 颜色 的	太阳 是 什么 颜色	我 也 有 什么 的 时候 作文
益虫 有 那些	秋天 还有 那些 水果 呢	谁 带 我 打 奥拉 星 圣光 修罗 伙伴 试练
那 您 稍 等 我 帮 您 查询 下	亲 稍 等 我 帮 您 查询 下	最 珍贵 的 是 什么
谁 有 风暴 英雄 激活码	玩 联盟 ， 你 最 喜欢 用 哪个 英雄 ？	请 您 让 账户 持有者 本人 来访 的 ， 麻烦 了 。
怎么 刷 游戏 人生 兑换 点	求 生死 狙击 刷 金币 软件	您好 ， 亲爱 的 客户 ， 谢谢 给 小 二 服务 您 的 机会 ， 麻烦 您 说 一下 您 的 问题 ， 谢谢您 。
您好 ， ， 麻烦 您 提供 这笔 交易 的 转账 流水号 ， 以 2015 开头 的	您好 ， 麻烦 您 把 这个 交易 的 转账 流水号 2015 开头 的 提供 一下	姓常 的 男生 取 什么 名字 比较 好听
哪里 能 买 到 日语 原版 或者 日文版 的 轻 小说 。	求 个 能 看 或 下载 日文 轻 小说 的 地方	谁 有 这个 的 情侣 头像 ？
毓 字 有 什么 含义	翀 字 的 含义 是 什么 ？	我 的 世界 有 这样 的 地图 吗 ？
晚上 吃 啥 饭 比较 好 ？	一般 晚上 都 吃 什么 比较 好 ！	求 一部 小时候 看 的 电影
山东 威海 金海 渔业 股份 有限公司 是 真的 吗 ?	山东 威海 金海 渔业 股份 有限公司 招聘 是 真的 吗	怎么 修改 百度 账号 的 昵称 ？
天天 酷 跑 如何 开 挂	天天 酷 跑 怎么样 开 挂	日本 侵略 过 中国 几次
在 哪 下载 电影 同桌 的 你 完整版	同桌 的 你 电影 完整版 哪里 可以 看	有钱 就是 任性 ，
固安 别墅 价格 抑	固安 别墅 价格 昼	杭州 下沙 属 什么 区
功夫 派 兔子 用 什么 灵兽 好	功夫 派 兔子 用 什么 灵兽 好 ？	这个 图片 中 的 女孩 叫 什么 名字
爸爸 去 哪儿 主题曲 怎么 下载	爸爸 去 哪儿 主题曲 下载	在 什么样 的 情况 下 会 流产
有没有 什么 好玩 的 手机游戏	有没有 什么 好玩 的 手机游戏 。	苍穹 之 剑 怎么 卡 天 之 视频 教学
怎么 能 快速 发烧 急 ！	怎样 让 自己 快速 发烧	有 创意 的 生日礼物
驾驶证 违章 怎样 能 查询 到	如何 查询 驾驶证 违章	衣服 的 尺码 问题
三角形 的 性质 有 哪些	三角形 的 性质	为什么 奔跑 吧 兄弟 大 电影 ， 没有 邓 超
求 一部 老 上海 电视剧 的 名字 ~	求 上海 数字电视 播出 的 一部 电视剧 名字	我 太 内向 ， 不会 与 别人 聊天
手机 内存 怎么 扩展 ?	手机 内存 怎样 扩展	这边 的 状态 显示 是 等待 确认 的
有 什么 有效 的 瘦 脸 方法 ？	有效 的 瘦 腿 方法 是 什么	泥鳅 怎么 煮 好吃 ？
新 商 盟 烟草 网上 订货 付款	新 商 盟 烟草 网上 订货	谁 有 天空 之 城 的 简谱 啊
发烧 后 的 症状 都 哪些	发烧 有 哪些 症状	灭蚊灯 哪个 品牌 好
男人 最 喜欢 女人 什么 地方	男人 喜欢 女人 吻 什么 地方	什么 酒 心 巧克力 好吃
梦见 衣服 烂 了 ， 是 什么 意思	梦见 捡 棉 衣服 穿 是 什么 意思	晚上 睡觉 前 喝 醋 有 什么 好处
电水壶 哪个 牌子 好 ？	哪个 牌子 的 电水壶 好	他 是 你 爸爸 英文 怎么 说
图片 是 什么 动漫 谁 知道 ？	谁 知道 这 几张 图片 是 什么 动漫	百度 知道 要 怎么 改 用户名 ？
建议您 后期 操作 时 可以 留意 页面 的 到 账 时间 提示 、	今天 24 点 之前 到 账 的 具体 到 账 时间 以 页面 显示 的 为准 的 麻烦 了	头发 上 有 虱子 怎么 治
永恒 之 塔 怎么 完	永恒 之 塔 怎么 回 这样	如何 才能 在家 兼职 淘宝 客服
怎样 用纸 折 花	怎样 用纸 折 花 蓝	我 的 世界 火 石头 怎么 得
不胜其烦 的 ( 其 ) 是 什么 意思	奶奶 和 孙子 ( 女 ) 的 关系 叫 什么 ？	请问 图片 上 的 这个 植物 叫 什么 ？
这 幅 图片 是 哪部 动漫 的 ？	这 幅 图片 的 是 哪一部 动漫 啊	发 质 差 怎么办 ， 而且 很 毛躁 ？
求 小时候 的 一部 电影	求 一部 小时候 看 的 电影	您好 ， 是 帮 您 代付 人 的 收支 明细 截图 提供 给 您 ， 您 在 操作 上传 找回 支付 密码 即可
什么 牌子 的 摩托车 最好	摩托车 机 什么 什么 牌子 最好	武媚娘 传奇 的 片尾曲 是 什么 ？
什么 减肥 产品 效果 好	什么 产品 减肥 效果 好 ？	北京科技大学 钢铁 冶金 专业 怎么样
有 什么 好看 的 灾难片 啊 ？	有 什么 灾难片 好看 啊 。	手臂 上 的 肌肉 要 什么 练 ？
额头 算 饱满 吗 ，	这样 的 额头 算 饱满 吗	作文 是 什么 意思
址 可以 组成 什么 词	蝇 可以 组成 什么 词	蔡依林 和 周杰伦 能 结婚 吗 ？
吃 什么 东西 能 降血压 ？	什么 东西 是 降血压 的	淘宝 卖家 24 小时 未 发货 ， 申请 退款 能 成功 吗 ？
求 《 天空 之 城 》 的 合唱 谱	《 天空 之 城 》 粤语版 歌词	我 手淫 怎么 戒掉 。
家里 跑 来 一只 猫 还 生 了 娃 好不好	家里 来 了 一只 狗 好不好	黑人 为什么 吃 白巧克力 呢
近视眼 怎样 配 太阳镜	近视眼 的 人 如何 戴 太阳镜 ？	为什么 奔跑 吧 兄弟 电影 没有 邓 超
老虎 和 猫 是 什么 关系	猫 和 老虎 有 什么 关系 ？	我 的 世界 怎么 建 房子 ？
在 哪里 交 话费 便宜	哪里 充 话费 最 便宜	什么 马 两条腿 ，
新疆 都 有 什么 特产 ？	新疆 特产 是 什么 ？	还有 什么 东西 是 绿色 的 ？
谦卑 是 什么 意思 ？	谦卑 是 什么 意思	刨 腹 产后 怎样 瘦 肚子
这次 那 队 赢 的 可能性 大	法国 和 洪都拉斯 哪个 赢得 几率 大 ？	有 单身 美女 吗 ？
环卫工人 被 比喻 什么	把 环卫工人 比喻 成 什么 ？	什么 是 震动 棒
固执 的 反义词 是 什么 ？	为 你 变 乖 的 反义词 是 什么	城管 打人 事件 党中央 是否 参与
属鸡 女 跟 什么 属相 男 相配 合适 呢 ？	蛇 和 哪个 属相 最 相配 ？	世界 上 最 胆大 的 婚礼
为什么 女人 喜欢 留 长 头发 ！	为什么 女人 喜欢 留 长 头发 呢 ？	求 《 鬼畜 眼镜 》 漫画 全集
天 语 手机 要 怎么 刷 机 ？	天 语 手机 怎么 刷 机 啊	如何 开通 支付宝 和 财 付 通 呢
是 输入您 身份证 的 后 8 位 哦	请 输入 港澳 证件 的 后 4 位 （ 是 证件 上 的 身份证号 ）	尾牙 宴 从 什么 时候 开始
电脑 太卡 、 该 怎么 解决 ？	电脑 太卡 怎么 解决 ?	镁 锭 什么 颜色
怎样 对付 恶 婆婆	怎么 对付 婆婆	让 眉毛 最快 长 出来 的 办法
小船 怎么 画	怎么 叠 小船	后会无期 是 什么 意思 ？
步步高 音乐手机 主题曲 是 什么 啊 ？	步步高 音乐手机 的 主题曲 是 什么 ？	掌上 英雄 联盟
什么样 的 人 算是 帅哥 呢 ？	什么样 的 人 ， 才 是 帅哥	太 悲观 的 意思 是 什么 ，
新 淘宝 店 怎么 装修	怎样 给 淘宝 店 装修	现在 大学生 学 什么 专业 好找 工作
什么 外号 好听	有 什么 好听 的 外号 吗 ？	轮胎 选 什么 牌子
斩 赤红 之 瞳 什么 时候 更新	斩 ， 赤红 之 瞳 什么 时候 更新	阳历 8 月 23 日 是 什么 星座
为什么 生命 如此 脆弱 ？	人 的 生命 为什么 很 脆弱	如果 不是 您 自己 的 账户 的话 ， 您 可以 操作 一下 申诉 的
电脑 玩 游戏卡	电脑 玩 游戏卡 的 很	什么 输入法 好 用
根据 两 视图 补 画 第三 视图	根据 视图 ， 补 画 第三 视图	QQ 三国 怎么 快速 升级 ？
冰箱 什么 牌子 的 最好 ？	买 什么 牌子 冰箱 最好 ？	求 女生 唯美 意境 头像
单身 公主 相亲 记 的 结局 是 什么 ？	单身 公主 相亲 记 大结局 最后 一段 里 的 插曲 是 什么	家里 有 很多 小 飞虫 怎么办 ?
中国 主席 一届 几年	中国 主席 是 几年 一届 的	天天 酷 跑 怎么 更新 ？
徐州 属于 哪个 省 ？	常州 属于 哪个 省	怎么 做好 网络营销
有 什么 好玩 的 单机 的 手机游戏	有 什么 好玩 的 单机 手机游戏 没 ？	生死 狙击 刷 金币 软件 怎么 用
这个 图片 出自 哪部 动漫 ？	这个 图片 出自 哪部 动漫	网上 二手车 为什么 那么 便宜
您好 ， 辛苦 您 可以 换 个 时间段 拨打 一下 ， 辛苦 您 了 。	辛苦 您 换 个 时间段 拨打 一下 ， 辛苦 您 了 。	如何 查询 手机 的 总 通话时间 ？
今年 几号 开始 春运	今年 几号 春运 开始	脸上 痣 太 多 怎么办
怎样 破解 迅雷 会员 ？	怎么 破解 迅雷 会员	孕妇 做梦 梦见 自己 生 了 一个 头戴 王冠 的 小女孩
那个 是 贬义词 ？	那个 是 压敏电阻 ？	华硕 手机 怎么样
请问 图片 的 卡通人物 叫 什么 名字 吖	问 一下 图片 里 是 哪个 卡通人物 ， 叫 什么 名字	关于 孙悟空 的 成语
什么样 的 女人 叫 美女 ， 什么 标准	什么样 的 女人 才 是 男人 满意 的 标准	福建 林业 职业 技术 学院 美女 ？
请 您 在 今天 关注 一下 的 。	请 您 今天 关注 一下 的 。	绫 瀬 は る な 这个 名字 中文 是 什么
火线 追凶 2 全集 的 顺序	火线 追凶 全集 有 哪 几部	披星戴月 是 什么 生肖
现在 下 电影 一般 用 什么 软件	现在 都 用 什么 软件 看 电影	唐诗宋词 元曲 汉 什么
什么 输入法 好 用 一些	什么 输入法 好 用	鸶 是 什么 意思 呀 谢谢 大家 了
支付宝 充值 话费 不到 账 怎么办	请问 办 支付宝 怎么办 ？	微 信 我 把 一个 好友 删除 以后 的 问题
求 像 和 校花 同居 的 日子 一样 的 小说 。	小说 《 和 校花 同居 的 日子 》 里 的 哈 院	只要 不 听 劝告 是 什么 成语 带 一 的
送 老公 什么 生日礼物 好	想 送 老公 生日礼物 送 什么 好 ？	奥比 岛 谁 有 不要 的 红宝石 号
叉叉 助手 怎么 没有 天天 飞车	叉叉 助手 天天 飞车 ios 怎么 刷 分	肯德基 网上 订餐 等 了 很 久 怎么 查 啊
如何 与 羊 交配	猪 是 怎么 交配 的	如何 安装 石膏线
求 这 张 权 志 龙 的 原图	求 这 张 权 志 龙 的 原图 ！ 急 ！	宋朝 开国 皇帝 是 谁
这 是 出自 什么 动漫 ？	这 是 出自 哪个 动漫	上海 到底 多 大 d ?
谁 知道 这 女优 叫 什么 名字	谁 知道 这个 女优 的 名字 ？	全民 足球 好玩 不 ？
在 香港 买 什么 最 划算 ？	去 香港 买 什么 药 划算	新生儿 喝 奶粉 该 喝 多少 ？
图片 中 的 女孩 叫 什么 名字 。	这个 图片 中 的 女孩 叫 什么 名字	有 什么 个性 签名 是 关于 姐妹 的 ？
二次元 是 什么 意思 ？	被 人 说 长 的 二次元 是 什么 意思	贴 吧 长 姿势 是 什么 意思 ？
把 爱 带回家 的 主题曲 叫 什么 名字 ？	《 打 狗 棍 》 的 主题曲 叫 什么 名字 ？	这边 给 您 发送 邮件 操作 就 可以 的 ， 登录 密码 和 支付 密码 都 忘记 了 吗 ？
为什么 女人 总是 要 欺骗 男人 的 善良 ?	为什么 女人 总是 喜欢 欺骗 男人 的 感情 ！	这种 刘海 怎么弄 呢
如何 点亮 英雄 杀 图标 ？	英雄 杀 如何 点亮 图标	做 我 男朋友 吧 ？
李宇春 有 男朋友 吗 ？	李宇春 有 男朋友 了 吗	输入法 哪个 好 用 ？
什么 白酒 好	喝 白酒 后 吃 什么 好	如何 紧 致 脸部皮肤
披星戴月 是 指 什么 生肖	披星戴月 是 什么 生肖	奶奶 和 孙子 ( 女 ) 的 关系 叫 什么 ？
求救 啊 ! 怎么 用 代理 玩 街头 篮球 ~ 知道 的 告诉 我	在 新加坡 玩 街头 篮球 ， 找 哪个 代理 好 啊 ， 愁 死 了 啊	这个 动漫 女生 叫 什么 【 有 图片 】
淘宝 搜索 图片 不 显示	手机 所有 图片 都 不 显示	这 张 图 是 东方 神 起 在 哪里 的 写真
告诉 我 关于 异 界 女神 的 小说	谁 有 黄 的 小说 ， 要 很 黄 很 暴力 的	过期 的 身份证 可以 买 火车票 吗
用 什么 和 珍珠粉 当 面膜	什么 珍珠粉 做 面膜 好	情人节 送 什么 礼物 给 老婆
你 爸爸 怎么 了 英文	他 是 你 爸爸 英文 怎么 说	元旦 有 在 西安 找 兼职 的 吗
求 音乐 ： 小 三 泪 铃声	求 音乐 ： 马 林 巴 琴 铃声	喜欢 女孩 如何 让 她 对 我 有 好感 ！
为什么 那么 多 明星 喜欢 吸毒	为什么 那么 多 明星 吸毒	六年级 寒假 新时空 数学 答案
驾驶证 如何 查询 扣分	如何 查询 驾驶证 扣分	酸奶 一般 什么 时候 喝 最好 ？
成龙 最新 电影 是 什么 啊 ？	成龙 最新 电影 是 什么	赛尔 号 刷 米 币
梦幻 西游 浙江 二 区 灵隐寺	梦幻 西游 灵隐寺 合 过 区 没 ？	山东 青年 政治 学院 学费
狮子 老虎 谁 厉害 啊 ？	老虎 狮子 谁 厉害	我 爱 一个 人 ， 如何 让 他 爱 上 我
用 手机 上 淘宝	我 在 淘宝 被 骗 了 是 假 手机	猴子 为什么 喜欢 吃 香蕉 ， 为什么 它 不 喜欢 吃 榴莲
菜刀 可以 上 火车 吗	火车 上 可以 带 菜刀 吗	回合制 网页 游戏
求 本 小说	求 本 关于 狐 妖 的 小说	求 《 天空 之 城 》 原版 吉他谱
淘宝 跟 天 猫 跟 啊 里 巴巴 什么 关系	天 猫 和 淘宝 是 什么 关系 ？	人工 受理 要 上传 证件 ， 48 个 小时 受理 ， 加急 是 4 个 工作 小时 受理 ， 您 看 可以 吗 ？
这边 给 您 发送 邮件 就 可以 了 ， 登录 密码 和 支付 密码 都 忘记 了 吗 、	这边 给 您 发送 邮件 操作 就 可以 的 ， 登录 密码 和 支付 密码 都 忘记 了 吗 ？	我 的 世界 的 种子 代码 是 什么 ？
微 信 添加 银行卡 本人 怎么 更改	微 信 怎么 更改 银行卡	今天 是 什么 节日 ， 这么 多 放鞭炮 的
有 什么 有效 的 丰胸 产品	什么 丰胸 产品 有 效果	重庆 最 好吃 的 火锅 是 哪家
骑马 与 砍杀 火 与 剑	骑马 与 砍杀 急	什么 东西 减肥 效果 快
什么 是 痔疮 的 症状 图	长 痔疮 有 什么 症状	在 哪里 可以 看 《 匆匆 那年 》
我 的 世界 怎么 刷 石头	我 的 世界 里 石头 在 哪 挖	曲终人散 的 意思 是 什么 ？
三原色 是 什么	光 的 三原色 是 什么 ？	跑跑 卡丁车 怎么 刷 骰子
我 与 语文 阅读 答案	语文 所有 阅读 答案	吃 什么 食品 有助于 伤口 愈合
如何 做 葱 烧 海参	海参 怎么 吃 ？	怎样 让 肚子 变小 ？
相逢 何必 曾 相识 是 什么 意思 ？	相逢 何必 曾 相识 是 什么 意思	射精 快 是 什么 原因
完 本 小说 免费 下载	怎样 下载 完 本 小说	最近 的 新闻 是 什么 ？
天天 飞车 9 月 11 号 了 怎么 还 不 发 钻头	天天 飞车 连续 登录 到 今天 怎么 还 没 送 钻头 啊	果 果 什么 意思 ？
百度 推广 工具 茯	百度 推广 工具	找 一部 爱情 电影
红毛丹 怎么 吃	如何 吃 红毛丹	联通 3g 手机 能 用 移动 卡 吗
怎么 能 练出 翘 臀 。	怎样 练出 翘 臀	财富 值 怎么 获取 啊
晕车 有 什么 好 的 办法 解决 呢 ？	晕车 有 什么 好 的 办法 解决 吗 ?	李 敏 镐 ， 金 秀 贤 ， 你们 喜欢 谁
名 侦探 柯 南 大结局 什么 时候 出	名 侦探 柯 南 什么 时候 能 有 大结局 ？	电脑 桌面主题 下载 去 哪里 无毒
这个 视频 的 背景音乐 叫 什么 呀	这个 视频 背景音乐 是 什么 啊	这 台 电脑 怎么样 ？
我 姓 我心	我 姓 龙 我心 什么	哪里 卖 正宗 的 福建 辣椒 王
篮球 后撤 步 投篮 技巧 ？ 怎么 学 ？	2K10MP 模式 怎么 做 虚晃 后撤 步 等 精彩 的 动作 ？	那 这边 为 您 转接 对应 工作人员 帮 您 解决 可以 吗 ？
后会无期 什么 意思	后会无期 是 什么 意思 ？	麻烦 您 详细 说 下 问题 好 么 。 小 二 才能 快速 帮 您 查询 ， 也 能 为 您 省 下 许多 时间 呢 。
好听 的 儿童 歌曲 有 哪些 ？	有 哪些 好听 的 儿童 歌曲 ？	找 工作 哪个 网站 好
如何 删除 新浪 微 博	新浪 微 博 怎么 删除 啊	什么 牌子 的 面膜 最 补水 ？
什么 意思 ？ 我 还是 不 懂	这 不 不 孬 么 什么 意思	麻烦 您 提供 一下 您 身份证 的 末 8 位 ( 从 您 出生 月 . 日 往后 算 起 ) 辛苦 您 的 操作 . \
问 一部 舒淇 的 电影	一部 舒淇 的 电影	请问 这 是 什么 木头 手串 ， 怎样 ？
胸 小 怎么 变 大	怎么 让 视频 变 高清	这个 季节 西安 哪里 好玩 ？
国内 的 手机卡 在 国外 能 用 吗	国内 手机卡 在 国外 能 用 吗	2K10MP 模式 怎么 做 虚晃 后撤 步 等 精彩 的 动作 ？
闺 蜜 结婚 应该 送 她 什么 礼物 呢	闺 蜜 结婚 送 什么 礼物 好 啊	表情图 猜 成语 ， 求 答案 ！
我 的 世界 南瓜 灯 怎么 拆	我 的 世界 有 南瓜 林 吗	收藏 人民币 有 价值 吗 ？ 收藏 那 一套 好 呢 ？
这 首歌 名字 是 什么	求 这 首歌 的 名字	我 得 电脑屏幕 图标 总 有 向 右 的 拖 影 是 怎么回事 啊
哈 奇 小镇 玩 不了 ， 说 没有 关联 的 程序 来 执行 操作	哈 奇 小镇 祖 玛 为啥 我 玩 通关 了 也 不 给 我 金橘 种子 ？	在 淘宝 买 东西 可以 用 手机卡 付钱 吗 ？
喜闻乐见 什么 意思	喜闻乐见 是 什么 意思 了	周 公 解梦 梦见 蛇 ， 吃 蛇 蛋 怎么办 ？
老 男孩 的 电影 哪里 有	老 男孩 的 电影 哪里 有 啊	这个 怎么 写 ， 英文
逆 战 安装 不了	剑灵 为什么 会 这样 不能 安装	三星 手机 怎么 自动 接听
这 台 电脑 怎么样	这 台 电脑 怎么样 ？	这 只 兔 兔 是 什么 品种 ？
把 词语 补充 完整 ： 光 ( ) ( ) 目	把 词语 补充 完整 。 ( ) 才 是 ( )	三 挡 电动车 限速 器 怎么 调
找 一部 以前 的 电视剧	求 一部 以前 的 电视剧	这 是 什么 品种 狗狗
紫 红薯 怎么 吃	红薯 粉 怎么 做	男士 手表 什么 品牌 好
农村 怎样 致富	农村 人 怎样 致富	我 想 买 个 新手机 ， 求 推荐
精子 是 什么 样子	人 的 精子 是 什么 样子	冲动 是 魔鬼
您好 ， 工行 的话 限额 是 单笔 5000 、 单日 5 万 、 单月 5 万 的 哦	实名 类 交易 （ 如 ： 买 机票 / 火车票 / 彩票 ） 单笔 3 万 、 单日 3 万 、 单月 无 限额	广东省 省会 是 哪里
我 的 世界 下载	我 的 世界 你 这个 哪里 下载 ？	真的 十分 抱歉 这个 是 需要 账户 本人 咨询 这边 才 是 可以 的 。
四海为家 的 为 字 是 什么 意思	四海为家 的 意思 是 什么	江苏 沭阳 属 哪个 市
大家 有 什么 新年 愿望 ？	大家 的 新年 愿望 是 什么	怎样 做生意 才 会 赚钱 呢
用 什么 泡 燕麦片	燕麦片 有 什么 用	郑明明 的 化妆品 怎么样 啊 ？
御 龙 在 天 时装 怎么 得	御 龙 在 天 怎么 得 金子	这 是 哪部 电影 还是 电视剧 里 的
手表 在 哪个 网站 买好 ？	买 手表 从 哪个 网站 上 买好 呢	远 在 咫尺 什么 意思
什么 牌子 护手霜 好 ？	这个 是 什么 牌子 的 护手霜	植物 大战 僵尸 在 哪里 下 ？
您好 ， 辛苦 您 核实 一下 您 的 收支 明细 是否 有 资金 支出	辛苦 您 查询 一下 您 的 余额 宝 的 收支 明细 的	深海 之谜 的 护肤品 怎么样 ？
浓 氯水 什么 颜色	什么 材质 的 衣服 又 薄 又 保暖 ？	北风 呼 什么
今年 大学 什么 时候 放寒假 ？	大学 今年 什么 时候 放寒假 ， 会 不会 提前	137 * * * 这个 手机号 呢 ？
网络 理财 安全 吗 ？ 从来 没 尝试 过 呢 。	红 岭 创投 网络 理财 靠 谱 吗 ， 真的 很 安全 吗 ?	家里 米 生 蛆虫 是 什么 意思
按键精灵 代码 改成 后台	按键精灵 后台 代码 求助	怎样 登陆 支付宝
加 偏旁 组词 ： 艮	己 的 加 偏旁 组词	奶粉 快 过期 了 还 能 喝 吗
微 商 如何 代理	开 网店 怎么 找 代理	侠盗 飞车 罪恶都市 怎么 改 车
三农 是 什么	什么 是 三农	男人 为什么 喜欢 胸 大 的 女人 ？
江苏 移动 掌上 营业厅 中 手机 点 了 注销 怎么办	掌上 营业厅 江苏 移动 猛击 送 流量 怎么 到 不了 帐户	解梦 梦见 狗 咬 死 狗
姐弟恋 好不好 ？	姐弟恋 好不好	爱情 雨 夏 娜 的 手机 铃声
爸爸 去 哪儿 第二季 多多 和 贝 儿 为了 饼 吵架	爸爸 去 哪儿 2joe 和 贝 儿 谁 大	长寿 花 什么样 啊
笨拙 丶 不幸 的 近义词 是 什么	笨拙 的 反义词 是 什么 ?	怎样 下载 天天 酷 跑 老 版本
什么 的 细雨	细雨 过 了 什么 雨	按揭 是 什么 意思
嘎嘎 嘎嘎 刚刚	世界杯 冠军 竞猜 开始	新 概念 英语 第二册 练习册 21 练习 答案
采纳 第一个 对 的 成语	猜 成语 。 第一个 必 采纳	摩尔 庄园 东部 游乐场
推荐 几个 好玩 的 小游戏 ，	推荐 几个 好玩 的 小游戏 ！	相逢 何必 曾 相识 是 什么 意思
圆通 快递 的 速度	关于 圆通 快递 的 速度	藏 灰色 是 什么 颜色 啊
有 什么 好看 的 电视 ？	有 什么 好看 的 电视	哈 奇 小镇 进不去
广袤 的 近义词 是 什么 ？	广袤 的 近义词 是 什么	王 俊 凯 喜欢 什么 女生
中学生 怎么 减肥 ？	中学生 怎么 减肥	求 驾校 类 广告语
女性 卵巢 保养 吃 什么 药 ?	女性 保养 卵巢 吃 什么 产品 好	求 听 你 听 我 张 杰 伴奏
剑灵 天 翔 如何 找回	剑灵 天 翔 怎么 找回	手机 铃声 啦 啦 啦 啦
三星 手机 在 哪里 买 ？	三星 手机 好 在 哪里 ？	你 是 在 哪 上学 的 ？ 哪个 学校 的 ？
跑跑 卡丁车 好玩 么 ？	玩 跑跑 卡丁车 大家 都 说 我 卡	男人 在 什么 情况 下 容易 有情人 或 做 出轨 的 事情 呢
怎样 让 微 信 无限 漂流瓶	微 信 漂流瓶 怎么 无限	怎样 可以 瘦 腿 ？
历史 典故 的 成语 有 哪些	来自 历史 故事 的 成语 有 哪些	关于 黑社会 的 电视剧 叫 什么 ？
有 什么 好听 的 来电 铃声	谁 有 啥 好听 的 来电 铃声 ？	红薯 粉 怎么 做
我 把 朋友 的 女朋友 给 上 了	上 了 女朋友 的 朋友	求 惩罚 军服 系列 全集 TXT
推荐 电视剧 ！	推荐 部 电视剧	什么 祛斑 的 产品 效果 好
哪个 手机 播放器 是 可以 在 手机 上 直接 下载 电影 的	手机 哪个 播放器 能 缓存 电影 ， 而且 电影 电视 很多	吃饭 睡觉 打 豆豆 、 是 什么 意思
您 不要 关闭 我们 的 对话框 然后 在线 等待 就 可以 的 哦	您 在线 等待 一下 就 可以 的 ， 不要 关闭 对话框	青蛙 有毒 吗 ？
做 视频 用 什么 歌曲 好	百度 视频 好 还是 什么	安徽 警官 职业 学院 怎么样 ？
谁 用 过 奇迹 面膜 , 效果 如何 ！	奇迹 面膜 具体 怎么样 谁 了解	在 淘宝网 上 怎么 投诉 商家 呢 ?
中国 有 什么 动漫 好看 啊 ？	中国 动漫 有 什么 好看 的 吗	屏幕 分辨率 怎么 调
什么 牌子 的 熨斗 最好	什么 牌子 的 熨斗 最好 呢 ？	京东 商城 是 怎样 付款 的 ？
能 不能 再 爱 我 一次 ？	我 想 看 一起 再 看 流星雨 ，	关于 恐龙 的 一部 电影
头发 毛躁 怎么办	怎么 洗澡 又 快 又 干净	1977 年 农 厉 5 月 28 日 中午 1 点 30 分 出生 五行
上 传到 土豆 上 的 视频 怎么 那么 模糊	怎么 把 视频 上 传到 土豆 网上	流通 过 的 人民币 还有 价值 吗 ? 能 不能 收藏 ?
请问 您 操作 时 提示 的 账户 是 您 的 吗 ？	您 之前 操作 转账 是 怎么 成功 的 ， 就是 怎么 操作 的 ， 辛苦 您 了 。	手工 巧克力 怎么 制作 ？
最快 减肥 有 什么 好 方法 呢 。	用 什么 方法 减肥 最快 ？	亲 ， 是否 可以 使用 花 呗 以 付款 界面 为准
剑灵 高级 衣料 怎么 来	剑灵 高级 衣料 怎么 得	如何 制作 闪 字 图片 ？
橙 光 游戏 的 封面 制作	橙 光 游戏 制作 封面	什么 的 梦想
洗澡 是 用 沐浴露 好 还是 香皂 好 ？	洗澡 用 香皂 好 还是 用 沐浴露 好 ？	成语 啥 个 相 呼应
周 公 解梦 孕妇 梦见 蛇	周 公 解梦 ， 孕妇 梦见 被 蛇 追	我 的 世界 手机 版 谁 能 和 我 远程 联机
李医生 的 防晒 产品 怎么样	李医生 去 痘 的 产品 效果 怎么样	我 对 你 的 爱 用 日语 怎么 说
这个 是 什么 表情 包 ？	这个 表情 叫 啥	去 了 皮 的 煮 鸡蛋 滚 脸 有 什么 好处
矫情 的话 什么 意思 ？	矫情 是 什么 意思 啊 ？	孕妇 能 吃 浑 香菜 吗
如何 按摩 前列腺	自己 怎么 按摩 前列腺	问道 中 妖魔 道 任务 找 谁 做
传奇世界 屠龙刀 在 哪里 买	传奇世界 哪里 爆 屠龙刀 ？	支付宝 支付 密码 忘记 了
有 什么 软件 可以 送 流量	什么 软件 可以 送 流量	谁 有 这 张 图片 的 高清 壁纸 ？
韩国 电影 爱人 的 完整版 ？	同桌 的 你 电影 完整版 ！	有 什么 好玩 的 网络游戏
在 家里 怎么 赚钱 。 有 电脑	在 家里 有 电脑 怎么 挣钱	安徽 简称 什么 ？
戚 风 蛋糕 如何 不 回 缩	如何 让 戚 风 蛋糕 不 回 缩	不可一世 什么 意思
我爱你 用 韩文 怎么 说 ？	我爱你 的 韩文 怎么 写	关于 网页 设计 的 一个 问题
宁波 北仑 附近 哪里 有 批发 女 包 的 ？	郑州 哪里 有 女 包 批发 ？	只有 身份证 复印件 可以 取 火车票 吗
为什么 有些 二手车 那么 便宜	网上 二手车 为什么 那么 便宜	南京 盐水鸭 好吃 吗 ？
这 是 哪个 动漫 里 的 女 角色 呢 ？	这 是 哪个 动漫 人物 还是 什么 ？	惬意 是 什么 意思
微 信 怎么 删除 好友	微 信 上 怎么 删除 好友	是 什么 类型
求 装饰 公司 广告词 ， 美 铭 装饰	求 装饰 包装 设计 公司 广告语	蓝牙 耳机 充电器 是 什么 啊 ，
电热水壶 什么 牌子 好 。	什么 牌子 的 电热水壶 好	大学 今年 什么 时候 放寒假 ， 会 不会 提前
同桌 的 你 在 哪 看 完整版 电影 ？	在 哪里 可以 看 《 匆匆 那年 》	穗 组词 求学 霸
刘德华 结婚 了 没有	刘德华 结婚 没有	最强 的 奥特曼 是 谁 ？
平安夜 要 送 什么 礼物 ？	平安夜 要 送 什么 礼物 给 他 ！	怎样 让 自己 快速 发烧
女朋友 突然 和 我 说 分手	我 女朋友 突然 跟 我 分手	谁 有 鹿 晗 穿 这样 的 照片 …
你 这么 吊 你 家里人 知道 吗	就 这样 被 你 征服 谁 唱 的 啊	拉 豆豆 什么 意思
没有 在 您 的 这个 账户 中 查询 到 是 有 操作 转账 的 。	核实 您 的 这个 资金 的 转账 是 处理 中 的 ， 目前 是 需要 您 在 今天 的 24 点 之前 关注 的	怎么 用 手机 复制 电视 遥控器
婴儿床 什么 牌子 好	婴儿床 什么 牌子 好 ？ 求 荐 ？	埋怨 的 近义词 是 什么
我 的 汤姆 猫 怎么 下载	我 的 汤姆 猫 下载 。	谁 知道 图片 这个 女 的 叫 什么
社会保障 卡 有 什么 用	社会保障 卡 有 什么 用 ？	求 幸福 花园 全集 下载 。 、
怎么样 才能 中 双色球 一等奖 呢 ？	怎么样 才能 中 双色球 一等奖	太阳 是 什么 颜色
这个 是 什么 字体 的 英文	这个 英文 字体 是 什么 ？	什么 浏览器 玩 网页 游戏 好
有 什么 好听 的 伤感 的 歌	有 什么 好听 伤感 歌 吗	疯狂 猜 图 的 答案
怎样 提高 自身 气质 ？	如何 提高 自身 的 气质 呢 ？	中国 达 人 秀 第三季 上海 报名 地点 在 哪里 ？
广州 哪里 有 草莓 摘	在 广州 哪里 可以 摘 草莓	这 是 什么 牌子 的 导航 ？
回音 哥 毕加索 。	毕加索 和 回音 哥	老婆 生日 送 什么 礼物 好 啊
人 与 动物 的 最大 区别 是 什么	人 与 动物 最大 的 区别 是 什么	谁 送 我 天天 酷 跑 钻石 礼包
奔跑 吧 兄弟 电影 哪里 能 看 ？	奔跑 吧 兄弟 电影 在 哪里 能 看 ？	求 袁行霈 《 中国 文学史 》 名词解释 ！
你们 的 梦想 是 什么	什么 的 梦想	高中数学 ， 数列 问题 。
翘翘板 ( 打 一 成语 ) 。	翘翘板 ( 打 一 成语 )	谢文东 在 哪里 看
那 我 为 您 创建 受理 单 修改 您 看 可以 吗	我 为 您 创建 受理 单 修改 可以 吗 亲	止咳 糖浆 哪个 牌子 好
求 这个 电影 名字	求 这 两部 电视剧 的 名字 谢 啦 }	这边 查询 这个 支付宝 账户 已经 认证 了 ， 您 有 身份 信息 修改 过 吗
北京 逛街 哪里 好 ？	北京 逛街 哪里 好	公安局 与 派出所 的 区别 是 什么 ？
淘宝 装修 是 怎么 做 的 啊	淘宝 店铺 装修 和 推广 怎么 做 啊	为什么 那么 喜欢 听 音乐
剩 的 米饭 可以 用来 做 什么 ？	蒸 米饭 什么 锅	关于 男生 发型
求 比值 怎么 求 ？	求 比值 ， 怎么 做	QQ 三国 开 商行 要 什么 东西
失败 ， 是否 有 收到 邮件	请问 是否 收到 了 审核 失败 原因 的 短信 或者 是 邮件 呢 ？	我 在 淘宝 被 骗 了 是 假 手机
怎样 去除 保温杯 的 异味 ？	如何 去除 保温杯 内 的 异味	男人 有没有 生育 一胎 后 就 没有 生育能力 的 ?
QQ 三国 怎么 快速 升级 ?	QQ 三国 怎么 快速 升级 ？	郑州 什么 时候 下雪 ？
好久不见 你 还好 吗	好久不见 ， 你 还好 吗 ？	总是 掉 网 怎么回事
什么样 的 情况 下 容易 流产	在 什么样 的 情况 下 会 流产	带鱼 的 鳞 能 吃 吗 ？
我 的 世界 手机 版 存档	我 的 世界 手机 版 存档 怎么 用	剑灵 为什么 会 这样 不能 安装
营业执照 能 贷款 吗 ？ 能 贷 多少 ？	营业执照 可以 贷款 吗 ？	我 想 我 是 好人
为什么 女人 要 和 男人 交配	为什么 男人 女人 要 交配	如何 解除 父子关系 ？
做 埋线 双眼皮 多少 钱 ？	北京 做 双眼皮 多少 钱 ？	那 您 就是 还款 成功 了
地税局 代 开 建筑业 工程 发票 需要 什么	什么样 的 发票 可以 地税	周 公 解梦 ， 孕妇 梦见 被 蛇 追
这 是 什么 酒 ， 价格 多少	这 是 什么 烟 啊 价格 多少 ？	温州 哪里 有 好玩 的 …
如何 在 微 信 上 加入 群 ？	在 微 信 群 , 如何 请 其他人 加入 群 。	这 幅 图片 的 是 哪一部 动漫 啊
我 第三笔 是 什么 ？	爽 的 第三笔 是 什么	虎 妈妈 兔 爸爸 生 羊 宝宝 好 吗
有钱 就是 任性 。 没 钱 就 得 认命 。	有钱 任性 没 钱 认命	游戏王 之 混沌 力量 - 城 之内 篇 汉化版
电子称 怎么 调 ？	我 的 电子称 怎么 修 ？	为什么 女人 喜欢 留 长 头发 呢 ？
手机 拨号键 找 不到 怎么办	我 手机 拨号键 找 不到 了	求 音乐 ： 爱 我 就 亲 我 吧
谁 有 黄页 免费 的	谁 有 免费 的 黄页 ！	手机游戏 推荐
查 星座 是 论 生日 的 阳历 还是 阴历	查 星座 用 阳历 生日 还是 阴历 的	红 米 手机 怎样 拍照
歌名 有 爱 字 的 歌 ， 歌名 三个 字	第三个 字 是 爱 的 七个 字 歌名	如何 设置 贴 吧 头像
为什么 我 的 电脑 无法 切换 输入法	为什么 我 的 电脑 不能 切换 输入法	女士 手表 什么 牌子 好
怎么 修改 淘宝 评价	淘宝 评价 怎么 修改	女士 手表 品牌 有 哪些
牵挂 是 什么 意思	从此 了 无 牵挂 什么 意思	北京 那里 最 繁华 ？
怎样 对付 职场 中 的 小人 ？	如何 对付 职场 小人 ？	您好 ， 麻烦 您 把 这个 交易 的 转账 流水号 2015 开头 的 提供 一下
什么 饮料 喝 了 最 提神 ？	什么 饮料 提神 ？	有些 什么 营养 汤
整 蛊 是 什么 意思 ， 来 人 哦 ， 谢谢	鸶 是 什么 意思 呀 谢谢 大家 了	手机 充电 慢 ， 什么 原因 ， 怎么办
怎么 戒掉 手淫 ？	我 手淫 怎么 戒掉 。	求 生死 狙击 刷 金币 软件
什么 的 花香	什么 花香 ， 为什么	谁 有 啥 好听 的 来电 铃声 ？
现在 的 老师 都 怎么 啦	现在 的 老师 怎么 都 这样 ？	肾虚 会 掉头发 吗 ，
终极 宿舍 什么 时候 播	终极 宿舍 过 了 做 什么	兔子 吃 什么 死
皮带 有 什么 品牌 ？	这个 是 什么 品牌 皮带	开 网店 怎么 找 代理
杏花 是 什么 颜色	杏花 是 什么 颜色 的 ？	剑灵 天 翔 怎么 找回
表示 走 词语 一个 字	形容 都 很 臭 四个 字 词语	中国 现当代 文学史 笔记
淘宝 买 东西 可靠 吗 ？ 具体 程序 ？	淘宝 上 买 东西 便宜 点 吗 ？ 可信 吗 ？	淘宝 手机 店铺 怎么 装修 ？
有 的 美女 还是 单身 吗 ？	有 单身 美女 吗 ？	万圣节 给 女朋友 送 什么
请问 这 是 什么 漫画	请问 各位 ， 这 是 什么 漫画 ？	鸡蛋 和 面粉 能 做 什么
谁 帮 我 想 一个 可爱 的 个性 签名	请 帮 我 找 一个 可爱 的 个性 签名	奇迹 面膜 具体 怎么样 谁 了解
求 鼠 猫 同 人文 包 ！	求 鼠 猫 同 人文 谢 啦	邓 紫 棋 为什么 总 喜欢 皮 裤
冬天 为什么 不 下雪	北京 的 冬天 冷 么 穿 什么 就 可以 了	孕妇 喝 什么 牌子 的 牛奶 好 ，
请问 这 女 叫 什么 名字 ？	请问 这 女 的 叫 什么 名字	现在 什么 行业 最 挣钱 ？
手指 操 怎么 做	怎样 跑步 又 快 又 不 累	梦幻 西游 可以 赚钱 吗 ？
明星 是 怎样 减肥 的 ？	明星 一般 都 是 怎样 减肥 的 ？	我 的 世界 画 怎么 合成
亲 ， 目前 这个 账户 是 已经 实名 认证 了	非常 抱歉 亲 ， 您 已经 实名 效验 了 ， 是 不能 修改 认证 的 信息 的	新 天龙八部 问题
古 剑 奇谭 全集	古 剑 奇谭 全集 在 哪 看	这 是 什么 牌子 的 口红
终极 宿舍 什么 时候 播出	终极 宿舍 什么 时候 更新	苹果 手机 怎么 在 微 信 上 制作 链接
女人 的 下面 是 什么 样子 的 ？	女人 下面 是 什么 样子 的	女朋友 生气 了 ， 我 该 怎么办 呢 ？
谁 有 鹿 晗 的 照片	谁 有 鹿 晗 穿 这样 的 照片 …	海参 怎么 吃 ？
玩 网页 游戏 用 什么 浏览器	什么 浏览器 玩 网页 游戏 好	汽车 加装 包围 更改 外观 算是 非法 改装 吗
孤岛 猎鹰 什么 时候 上映 啊	神雕侠侣 什么 时候 播	有 什么 少数民族 贴 吧 吗
埋怨 的 近义词 是 什么 词	埋怨 的 近义词 是 什么	喜欢 的 女生 不理 我 ， 怎么办
赛尔 号 经验 券 怎么 用	赛尔 号 怎么 刷 经验 ？	我 的 武媚娘 妆 如何
这 是 什么 石头 值钱 吗 ？	这 是 什么 石头 值钱 吗 ?	守护 甜心 第四部 在 什么 出
拍 婚纱照 怎么 笑 才 好看	短发 拍 婚纱照 怎么 才 好看	胡 莱 三国 中 如何 刷 将 和 功勋 呢
上班族 找 兼职 做 ， 做 什么 好	上班族 兼职 什么 好	郴州 明星 学校 高中 寄宿生 一年 要 花 多少 钱 ？
失败 了 去 支付宝 首页 点击 上面 的 小 闹钟 小 闹钟 上 有 退款 的 时间 哦	点击 【 查看 】 后 ， 页面 会 显示 该笔 退款 的 详情 ， 退款 去向 ， 退回 时间 等 ， 请 关注 。	北京 798 艺术 区 里面 有 个 技校 叫 什么 名字 ？
什么 老牌子 的 护手霜 好	什么 牌子 的 护手霜 好 啊 , 最好 是 不 太贵 的	如何 去除 保温杯 内 的 异味
怎么样 可以 让 眼睛 消肿	怎么样 让 眼睛 消肿 ？	那个 是 压敏电阻 ？
花瓶 什么 意思 ？	花瓶 是 什么 意思 ？	胡萝卜 怎么 做 才 好吃
这 是 什么 香水 。	这 是 什么 香水 ， 怎么 读	这 是 什么 植物 的 叶子
天 猫 盒子 和 小米 盒子 哪个 好	天 猫 盒子 和 小米 盒子 那个 好	急 找 一部 电视剧
卡通 电脑 主题 要 去 哪里 下载	电脑 桌面主题 下载 去 哪里 无毒	征途 天马 怎么 得
我 这 是 什么 脸型 ？ 适合 什么 帽子 ？	小 脸型 适合 什么 帽子	不识庐山真面目 识 什么 意思
这个 姿势 是 什么 意思 ？	贴 吧 长 姿势 是 什么 意思 ？	下载 书 旗 小说 旧版本
天天 酷 跑 怎样 可以 抽 到 舞狮 闹 闹 ！	天天 酷 跑 怎么 抽 到 舞狮 闹 闹	谁 能 把 黄 字 写 好看 点
我 最 喜欢 看 的 电视剧	你 最 喜欢 的 电视剧	怎么 在 百度 贴 吧 发帖子 急
什么 是 震动 棒 ？	什么 是 震动 棒	宠物 怎么 喂食
求 海绵 宝宝 哭 的 图片	求 海绵 宝宝 图片	什么 的 翠竹
大家 说 说 新年 愿望 是 什么 ？	你 新年 愿望 是 什么	为什么 我 的 电脑 不能 切换 输入法
粉色 用 什么 颜色 可以 调 出来	粉色 和 什么 颜色 最 搭	恩 ， 麻烦 您 了 ， 给 您 带来 的 不便 ， 希望 没有 影响 到 您 的 心情
找 我 的 世界 服务器	我 的 世界 服务器 是 什么 ？	孕妇 猕猴桃 能 吃 吗
谁 有 这 张 图片 的 高清 大 图 啊 ？	有 这 张 图片 的 高清 大 图 吗	您 的 账户 存在 风险 ， 需要 您 修改 登录 密码 和 支付 密码 的
我 帮 您 转接 到 对应 的 工作人员 帮 您 解答 可以 吗	那 这边 为 您 转接 对应 工作人员 帮 您 解决 可以 吗 ？	买 手表 从 哪个 网站 上 买好 呢
手机 版 三国 杀 怎么 刷 元宝	胡 莱 三国 中 如何 刷 将 和 功勋 呢	踌躇 是 什么 意思 ？
打架 最 厉害 的 狗 是 什么 狗	当 什么 兵 打架 厉害	怀孕 前 三个 月 可以 做爱 吗 ？
怎么 才能 快速 瘦 脸 ？	如何 快速 瘦 脸	网球王子 同人小说 。
夏天 做 什么 运动 对 减肥 最 有效	什么 运动 减肥 最 有 有效	你们 心目 中 的 女神 是 怎样 的 ？
现在 我们 国家 的 主席 是 谁	现在 国家 副 主席 是 谁	建议您 拨打 这个 淘宝 消费者 服务 热线 （ 买家 ） 0571 - 88158198
怎么 提升 淘宝 销量	淘宝 销量 怎样 提升	日本 车 最 贵 的 车
丰胸 用 什么 产品 好	什么 产品 丰胸 好	带 套 还 会 怀孕 吗 ？
世界 上 最 大胆 的 婚礼	世界 上 最 胆大 的 婚礼	这样 建议您 登陆 新 手机号 支付宝 账户 添加 邮箱 登录名 ， 取消 手机号 登录名 后 使用
您好 ， 请问 是 什么 交易 的 退款 ？	请问 是 什么 交易 的 退款 ， 亲	泰拉 瑞 亚 为什么 打不开
在 网上 怎么 查询 国税发 票 的 真伪	我 经常 出差 ， 如何 随时 查询 发票 的 真伪 ？	天天 炫 斗 刷 钻石 那些 是 真 得 吗 ？
怎样 快速 写 完 作业	怎样 快速 写 完 作业 ？	鼓舞 是 什么 意思
您 先 操作 试试看	您 现在 先 试试看	求 末世 系统 末世 重生 完 本 小说
葱 有 什么 营养 呢 ？	有些 什么 营养 汤	今天 七夕 你们 怎么 过 的
衣服 上 弄 上 了 油漆	在 图片 上 弄 上 文字	微 信 公众 平台 盈利 有 哪些 模式 ？
什么 望远镜 牌子 好	望远镜 什么 牌子 好	谁 知道 怎么 改 百度 云 的 账号 名
重 开头 的 成语	日 重 四 字 成语	百度 贴 吧 小尾巴 怎么 设置
什么 牌子 空压机 好 ？	什么 牌子 的 空压机 好 有 哪些 呢	打电话 时 如何 隐藏 自己 的 手机号码
我 要 下载 旧版 免费书 旗 小说	下载 书 旗 小说 旧版本	坦克 世界 金币 卡 哪里 买 的
怎么 才能 让 网速 变 快	怎么 才能 使 网速 变 快	凤凰 传奇 是 两口子 吗
这个 石头 有没有 收藏 价值 ？ 请 大家 鉴定	想 问 一下 这个 石头 有没有 收藏 价值 ？	为什么 我们 的 生活 有 太 多 的 无奈
曲终人散 是 什么 意思 ？	曲终人散 的 意思 是 什么 ？	这 是 哪个 动漫 人物 还是 什么 ？
100 元 以下 的 鼠标 哪个 玩游戏 比较 好	哪个 牌子 的 鼠标 键盘 玩游戏 好	兰 岛 物语 ( 少女 的 约定 ) 下载
什么 软件 可以 用 信用卡 充值	都 有 什么 软件 可以 用 信用卡 充值 呢 ！	如何 去除 鸡皮疙瘩 ？
大家 上班 都 玩 手机 么	上班 可以 把 手机 那 出来 玩 吗	网上 兼职 可靠 吗 ？
成龙 最新 电影 是 什么	成龙 的 最新 电影 叫 什么 ？	《 天空 之 城 》 粤语版 歌词
奔跑 吧 兄弟 中 最 喜欢 谁	你 最 喜欢 《 奔跑 吧 ， 兄弟 》 中 的 谁 ？	三国 战记 哪里 有 下载 ？
街头 篮球 是 什么	什么 是 街头 篮球 ？	世界杯 冠军 竞猜 开始
时间 笑 我 孤独 像 狗 的 繁体字 怎么 写	时间 带 不 走 我 对 你 的 思念 , 繁体字 怎么 写	喝 什么 牌子 的 羊奶粉 好 呢
仙人掌 怎么 养	仙人掌 类 的 蚧 壳 虫 怎么 治	什么 动物 代表 长寿
第一个 是 蛇 第二个 是 鸡 的 成语	含有 龙 与 虎 字 的 成语	什么 牌子 的 台灯 孩子 用 好
这个 是 大于号 ， 还是 小于号	么 做 的 ， 填 大于号 和 小于号	在线 免费 起名
打 酱油 是 什么 意思 ？	打 酱油 的 是 什么 意思 啊	什么 方法 脱毛 效果 最好
手机 看 视频 用 什么 软件 好 ？	什么 软件 可以 用 手机 拍 视频	梅 西 是 那个 球队 的 ？
怎么 抢 无线网 速	自己 怎么 装 无线网	是 需要 账户 本人 来访 核实 账户 信息 ， 建议您 联系 账户 本人 来访 核实 ， 麻烦 您 了 。
郑明明 化妆品 怎样	郑明明 的 化妆品 怎么样 啊 ？	天天 飞车 连续 登录 到 今天 怎么 还 没 送 钻头 啊
你 最 珍贵 的 是 什么	最 珍贵 的 是 什么	月球 还有 那些 未 解 之谜
求 好看 的 异 界 小说 。	求 好看 的 异 界 小说 ，	这 句 话 日语 怎么 说 呢 ？
宽慰 是 什么 意思 ？	宽慰 什么 意思	壁纸 和 家 乳胶漆 哪个 环保
手 发抖 怎么办 ？	狗狗 晕车 怎么 看 它 好 与 坏	网上 可以 做 什么 兼职
江西 理工大学 应用科学 学院 安全工程 专业 怎么样 ？	江西 理工大学 应用科学 学院 是 二本 吗 ？	衣服 上 的 胶 怎么 能 去掉
文明礼仪 手抄报	有关 文明礼仪 的 手抄报	一身两役 是 什么 生肖
关于 交通规则 的	关于 交通规则	送 客户 什么 礼物
我 和 我 的 舅舅 的 关系 叫 什么 ？	我 妈妈 的 舅舅 和 我 的 关系 称谓 是 什么 ？	作文 原来 我 也 拥有 怎么 多
梦见 自己 出轨	梦见 别人 劝 自己 出轨	小苹果 这 首歌 在 哪里 有 得 听 。
打 嘟嘟 是 什么 意思 ？	黑 嘟嘟 是 什么 意思	以 虫 治 虫 的 治 是 什么 意思
如何 健康 减肥 ？	怎样 健康 减肥	能 给 我 火影 同 人 漫画 吗
怎样 能 使 衣服 变 香 ？	怎么样 使 自己 的 衣服 变 香 啊	脚底 垫 豆腐 是 什么 意思
怎样 去除 鸡皮疙瘩	如何 去除 鸡皮疙瘩 ？	立顿 红茶 是 什么 茶
正月十五 开 什么 花	正月十五 是 什么 时候	请 您 今天 关注 一下 的 。
普通话 翻译成 粤语 ！	普通话 翻译成 粤语	怎么 查 到 开房 信息
你 知道 我 叫 什么 么	我 不 知道 要说 什么 ！	微 信 怎么 改 听筒 模式
什么 食物 能 去除 体内 湿气	什么 方法 可以 去除 体内 的 湿气	在 网络 上 有 什么 可以 兼职 的
鸡 哪里 有 鸡婆	哪里 有 鸡婆 店	死得其所 是 什么 意思 ？
起 凡 如何 刷 通宝	起 凡 怎么 冲 通宝	多少 金额 的 呢 亲 帮 您 核实 一下
香港 哪里 买 燕窝 好	香港 哪里 买 燕窝	我 宝宝 可爱 吗
血 粘稠 吃 什么 药	血 粘稠 吃 什么 药 ?	人情债 怎么 还 ？
世界 上 速度 最快 的 动物 是 什么 ？	世界 上 什么 动物 速度 最快	谁 有 铠甲 勇士 之 帝皇 侠
按揭 是 什么 意思 ？	按揭 是 什么 意思	近视眼 的 人 如何 戴 太阳镜 ？
关于 穿越 到 唐朝 的 小说	穿越 小说 ， 到 唐朝 的	用 没有 和 也 不 造句
成都 哪里 有 水果 批发市场 ?	成都 的 水果 批发市场 在 哪里 ？	怎样 减肥 最快 最 有效 运动
什么 手机游戏 像 英雄 联盟 一样	什么 手机游戏 和 英雄 联盟 一样	怎么 把 电视剧 下载 到 手机 上
黑人 为什么 吃 白巧克力 ？	黑人 为什么 吃 白巧克力 呢	什么 印象 了
文思 如 泉 什么 意思	文思 如 泉 是 什么 意思 ？	请问 ， 这个 头像 什么 狗 ？
天天 飞车 怎么 跑 高分 ？	天天 飞车 ， 怎么 拿 高分 。	上班 可以 把 手机 那 出来 玩 吗
有 什么 比较 好看 的 书 ?	什么 书 比较 好看 ？	我 的 世界 怎么 药 岩浆
原来 我 拥有 这么 多 作文	作文 原来 我 也 拥有 怎么 多	怎样 才 睡觉 不 做梦
天天 飞车 怎么 刷 高分	天天 飞车 怎么 跑 高分	阿里 妈妈 怎么 推广 的 ？
孕妇 能 吃 奇异果 吗	孕妇 能 吃 奇异果 吗 ？	给 宝宝 喝 什么 奶粉 比较 好 ？
癞子 斗地主 中 的 翡翠 怎么 获取 ？	天地 癞子 斗地主 都 是 怎么 作弊 的 ?	杨 幂 和 唐 嫣 谁 最 漂亮 ？
百度 知道 怎么 改 用户名 ！	谁 知道 怎么 改 百度 云 的 账号 名	买手机 买 什么 牌子 的 好 .
走过 路过 不要 错过 ！	哒 哒 哒 打打 打	求 一部 以前 的 电视剧
如何 安装 车牌 照	车牌 怎么 安装	那么 问题 来 了 ！
洛奇 英雄传 怎么 进不去	我 怎么 进不去 洛奇 英雄传	在 炫 舞 可以 删除 人物 吗
现在 做 什么 工作 最 挣钱 啊	现在 做 什么 工作 最 挣钱	金华 火腿 怎么 做 才 好吃
郝邵文 吴孟达 电影	惊天动地 电影 观后感	云南 普洱茶 哪个 牌子 好
凤凰 传奇 是 夫妻 吗	凤凰 传奇 是 两口子 吗	全职 妈妈 孩子 上 幼儿园 后 做 什么 工作 好
1960 年 五元 人民币 ， 值钱 吗 ？ 有 收藏 价值 没 ？	收藏 人民币 有 价值 吗 ？ 收藏 那 一套 好 呢 ？	形容 秩序 好 的 成语
这 是 哪部 动画 里 的 人物 ？	这 是 哪部 动画片 的 人物 ？	什么 牌子 的 沐浴露 好 ！
跪求 花粉 少女 注意 报 漫画	花粉 少女 注意 报 漫画 求 发	最新 好看 的 国产 恐怖片
您好 ， 是 10 元 的 这笔 吗 ？	您好 ， 是 300 的 这笔 吗 ？	现在 敢 什么 事 赚钱 。
一刻千金 ， 猜 一 生肖	读书 万卷 他 不厌 【 解 生肖 】	一般 晚上 都 吃 什么 比较 好 ！
怎么 赚 更 多 的 财富 值	怎样 可以 刷 财富 值	郭 德 纲 的 段子
苹果 手机 怎么 下载 铃声 ？	苹果 手机 如何 下载 铃声	怎么 让 身体 排毒 ？
惬意 什么 意思	惬意 是 什么 意思	六年级 上册 习作 一
如何 代理 奶粉 ， 代理 什么 牌子 的 奶粉 好 ！	孕妇 喝 什么 牌子 的 牛奶 好 ，	洗澡 用 香皂 好 还是 用 沐浴露 好 ？
求 一款 游戏 ， 赛车 的	求 一款 赛车 游戏	在 农村 现在 做 什么 农业 好
爱情 里 没有 谁错 谁 对 …	爱情 里 没有 谁 对 谁错 ？	国内 手机卡 在 国外 能 用 吗
跑步机 什么 牌子 好 ， 家用	什么 牌子 家用 跑步机 好	怎么 看 显卡 好坏 ？
不能 说 的 秘密 电影	电影 《 不能 说 的 秘密 》	【 理财 知识 】
生化危机 ： 浣熊 市 行动 问题 ！	关于 生化危机 浣熊 市 行动 的 问题	说 说 你 现在 ， 是 做 什么 工作
微 信 语音 聊天 没 声音 怎么弄	微 信 语音 存储 一段时间 就 没 声音	我 是 歌手 第二季 冠军 会 是 谁
功夫 派 恏 眼 在 哪	功夫 派 给 个 号	油性 头发 用 什么 洗发水 比较 好
下载 苍穹 之 剑 怎么 玩 不了	苍穹 之 剑 怎么 卡 天 之 视频 教学	骑马 与 砍杀 急
就是 您 注册 的 这个 邮箱 的 。	那 您 只能 是 用 邮箱 注册 了	火灾 时 ， 如何 逃生 ？
这 句 用 日语 怎么 说	这 句 日语 怎么 说 啊 ？	日本 人 是 人 吗 ？
关于 爱情 网名	关于 爱情 的 网名	今天 下雨 了
东北三省 是 指 什么	生活 也 是 这样 这样 是 指 什么	求 腾讯 微 博 邀请 码 一个
推荐 几本 小说	推荐 几本 小说 ！	怎么 才能 提高 羽毛球 技术
春江 水暖鸭 先知 。	“ 春江 水暖鸭 先知 ”	谁 有 奥拉 星 刷 奥 币 的 脚本
郑州 幼师 学校 有 哪些	郑州 有 那些 好 的 幼师 学校	形容 又 懒 又 萌 的 词语
谁 有 这 张 图片 的 高清 无 水印 图 ？	求 这 张 图片 的 高清 图 无 水印 ！	杭州 有 到 成都 的 动车 吗 ？
谁 能 帮 我 起 个 网名 啊 。	谁 为 我 起 个 网名	什么 导航 最好 用
寒假 新时空 六年级 上 数学 答案	六年级 寒假 新时空 数学 答案	尾号 4 位 多少
在家 带 孩子 怎么 兼职	在家 带 孩子 。 想 兼职 。	部落 冲突 重置 游戏
孕妇 那些 东西 不能 吃	孕妇 那些 东西 不能 吃 ？	有 什么 好玩 的 类似 天龙八部 的 网游
这 是 茶花 的 哪个 品种 ？	这 是 什么 品种 的 茶花 ？	英雄 联盟 和 梦 三国 哪个 更 好玩 ？
辛苦 您 耐心 等待 审核 找回 支付 密码	您好 ， 密码 锁定 辛苦 您 等待 三 小时 后 会 自动 解锁 的 ， 辛苦 您 了	北京 哪里 可以 学 骑马
求 大家 推荐 动漫 ！	求 推荐 动漫 ！	郑 大 与 嵩山 少林 武术 联办 的 学校 咋样
阿里巴巴 怎么 注册	怎样 注册 阿里巴巴 ？	农村 人 怎样 致富
霸气 女生 拽 个性 签名 有 什么	有没有 超 拽 的 个性 签名 啊	捡 肥皂 是 什么 意思
君子 脸 的 意思 是 什么	君子 是 什么 意思 ？	衰弱 的 反义词 是 什么
广东省 的 省会 是 哪里	广东省 省会 是 哪里	时间 带 不 走 我 对 你 的 思念 , 繁体字 怎么 写
女 客户 送 什么 礼物	送 客户 什么 礼物	老鼠 爱 吃 什么
哺乳期 可以 烫发 吗	哺乳期 能 烫发 吗	大写 万 字 怎么 写 ？
反义词 构成 的 成语	含有 反义词 的 成语 。	这个 英文 字体 叫 什么
叠 元宝 怎么 叠	元宝 是 怎么 叠 的	这 不是 没事找事 嘛
关于 英语 音标	英语 的 所有 音标 ！	欲 钱 买 短命 的 生肖 指 的 是 什么 ？
请问 是 到期 赎回 还是 提前 赎回 ？	是 等待 买家 付款 的 状态 的	这个 表情 叫 啥
桂圆 吃 多 了 上火 吗 ？	鲜 桂圆 吃 多 了 容易 上火 吗 ？	腾讯 新闻 和 网易 新闻 哪个 好
吃 香蕉 可以 减肥 吗	醋 泡 香蕉 能 减肥 吗	是 等待 买家 付款 的 状态 的
陈世美 是 什么 人	陈世美 是 什么	红豆 薏米 粥 能 减肥 吗
可以 赚钱 的 软件 有 哪些 ？	有 什么 软件 可以 赚钱 ，	有 什么 好看 的 电视剧
男人 喜欢 听 什么 话	为什么 那么 喜欢 听 音乐	好看 的 玄 幻 都市 小说
花 有 重开 日 的 上 一句 是 什么 ？	花 有 重开 日 ， 的 下 一句 是 什么 ？	京东 好 还是 亚马逊 好 ？
什么 牌子 的 女士 手表 好	女士 手表 什么 牌子 好	第一次 去 男朋友 家 见 家长 ， 该 怎么 做 ， 很 紧张
什么 牌子 贴 面膜 好 用	什么 牌子 的 面膜 好 用	天天 酷 跑 怎么 冲 钻石
为什么 女人 都 爱美 ？	女人 为什么 爱美	“ 安达 ” 蒙古语 是 什么 意思
这 是 什么 表情 ？	这 是 什么 的 表情 包 … ？	天天 飞车 怎么 跑 高分
怎么 下载 漫画 到 手机	怎么 下载 漫画 到 手机 里	怎么 下载 漫画 到 手机 里
现在 什么游戏 最 火	现在 玩 什么游戏 能 赚钱 ？	酸奶 加 红糖 怎么 喝 才能 减肥
该 如何 消除 脸上 的 痘痘 呀 ？	脸上 痘痘 怎么 消除	这 是 什么 的 表情 包 … ？
这个 韩国 网络红人 男 的 是 谁	这个 女 的 叫 什么 韩国 的 网络红人	语文 所有 阅读 答案
请问 飞机 上 怎么 找到 座位 ？	飞机 上 座位 怎么 找 ？	中国 十大 黑帮 老大 是 谁 ？
谁 有 奥比 岛 红宝石 号 ？	奥比 岛 谁 有 不要 的 红宝石 号	怀孕 吃 干 桂圆 好 吗
淘宝 店铺 装修 和 推广 怎么 做 啊	淘宝 店铺 装修 欢迎光临 怎么 做	就 这样 被 你 征服 谁 唱 的 啊
瞅 是 什么 结构 的 字	载 是 什么 结构 的 字	有钱 任性 没 钱 认命
地下城 与 勇士 哪个 角色 好玩	地下城 与 勇士 好玩 吗 ， 选 哪个 职业 最好 啊	什么 牌子 的 电热水壶 好
洛克 王国 洛克 快 打	洛克 王国 洛克 快 打 在 哪	刘 烨 和 谢 娜 什么 时候 分手 的
怎样 能 让 头发 蓬松	怎样 让 头发 蓬松 ？	传说 片尾曲 是 什么
今天 晚饭 吃 什么 ？	今天 晚饭 吃 什么 呢	天上 的 小白羊 ， 指 的 是 什么
帮帮忙 。 谢谢	帮帮忙 ． 谢谢 ．	什么 海鲜 好吃 啊
煲 猪肉 是 什么 意思	人家 说 吃 猪肉 是 什么 意思	三星 手机 好 在 哪里 ？
右 小手指 发麻 是 什么 原因	右手 小手指 发麻 已 两天 ， 不知 是 什么 原因	在 图片 上 弄 上 文字
属于 我 的 哪个 人 在 哪	你 是 在 哪 上学 的 ？ 哪个 学校 的 ？	四川 麻辣 面
怎样 有效 的 锻炼 腹肌	手臂 上 的 肌肉 要 什么 练 ？	怎么样 才能 知道 自己 的 手机 有没有 被 人 安装 窃听器
街头 篮球 怎么 充值 ？	街头 篮球 改 能力 怎么 改	上海 大计 数据 公司 怎么样 啊
家里 有 小 飞虫 怎么办 ？	家里 有 很多 小 飞虫 怎么办 ?	什么 产品 丰胸 好
花生 可以 怎么 做	如何 炖 熟 花生 ？	联通 卡 怎样 开通 来电显示
这 是 那 部 动漫 人物 啊	这 是 那 部 动漫 人物 ？	喜欢 搬弄是非 的 人 是 什么
求 惩罚 军服 系列 txt 全集	求 惩罚 军服 系列 全集 TXT	英语 的 所有 音标 ！
急 求 太极 气功 十八式 的 mp3 口令 音乐	太极 气功 十八式 口令 音乐	我 怎么 进不去 洛奇 英雄传
老人 本命年 送 什么 好 ？	老人 本命年 送 什么	开 汽车 美容店 的 利润 怎么样
求 此 女 名字 …	求 此 女 名字 ， 你 懂 的	矿泉水 莹 透 面膜 怎么 涂
胡子 长 得 快 怎么办 ？	胡子 长 的 太 快 怎么办 ？	刘德华 结婚 没有
上海 大宁 灵石 公园 里面 有没有 帐篷 租借 ？	上海 大宁 灵石 公园 晚上 几点 关门 啊 ？	发烧 有 哪些 症状
世界 上 最 贵 的 鱼 是 什么 鱼	世界 十大 淡水鱼 叫 什么 名	谁 有 这个 图片 或者 知道 她 是 谁
手机 用 什么 播放器 看 电影 好 ？	手机 看 电影 用 什么 播放器 好	最 难 做 的 饭 — 成语
小孩子 最 喜欢 什么	小孩子 喜欢 吃 什么 菜	花 有 重开 日 ， 的 下 一句 是 什么 ？
财富 值 怎么 获取	财富 值 怎么 获取 啊	求 这 张 图 的 完整 图片 ！
甘肃 建筑 职业 技术 学院 2015 年 单独 招生 考试题 纲	甘肃 建筑 职业 技术 学院 2015 年 新生 啥时候 军训	罗 志 祥 的 发型 叫 什么 ？
什么 牌子 的 唇膏	这 是 啥 牌子 的 唇膏	真的 很 抱歉 的 ， 小 二 这边 帮 您 转接 相关 工作人员 帮 您 核实 一下 ， 可以 吗
怎么 刷 空间 人气 ？ 还有 说 说	怎么 可以 刷 空间 人气 ？	什么 牌子 的 手表 好 ， 男士 的
血 钻 燕麦 怎么 吃	燕麦 面 怎么 吃	怎么 用 屏幕 录像 专家
谁 知道 这个 是 什么 牌子 的 包包	谁 知道 这个 包包 是 什么 牌子	测试 一下 你 的 前世 是 个 什么 人
这 脸型 是 什么	我 这 是 什么 脸型	现在 做 什么 生意 投资 少 风险 小 ， 赚钱快
它 的 剪 力图 和 弯矩 图 ，	这 悬臂梁 的 剪 力图 和 弯矩 图 怎么 画	那 可以 麻烦 您 在 推送 框 填写 一下 您 的 身份证 后 8 位 吗
我 吊 你 个 嗨 广东话 什么 意思	广东话 ， 知 你 爱 啊 飘 啦 是 什么 意思	斩 ， 赤红 之 瞳 什么 时候 更新
男士 黑色 休闲 布 裤 配 什么 色 的 鞋子 好看	黑色 男士 运动 休闲鞋 配 什么 裤子 好看 ？	怎样 给 淘宝 店 装修
怎么 注册 官方 微 信 账号	怎么 更改 绑定 微 信 的 手机号	什么 丰胸 产品 有 效果
高圆圆 和 黄海波 是 什么 关系	黄海波 和 高圆圆 什么 关系	牛肉 多少 钱 一斤
亲 ， 新年快乐 哦	新年快乐 ， 亲	我 可以 娶 乌克兰 美女 吗 ？
什么 是 胃溃疡 ？	胃溃疡 是 什么 ？	怎样 宰 鳄鱼 龟
我 怎么 没 匿名 悄悄话	怎么 发 匿名 悄悄话 ？	谁 有 什么 好 工作 给 我 介绍 一下
这 图片 是 什么 ， 哪里 的 ， 有 什么 寓意 。 谢谢	这 幅 图片 的 寓意 是 什么	田亮 是 哪里 人 ？
平行四边形 的 性质	平行四边形 的 性质 有 那些	这 狗 是 啥 品种 的 ？
怎么 用 苹果 手机 万能钥匙 ？	苹果 手机 万能钥匙 怎么 用	微 信 公众 平台 如何 盈利 ？
宜昌 ， 三峡 论坛 的 邀请 码	宜昌 三峡 论坛 的 邀请 码	为什么 我 的 耳机 输出 低音 时会 有 杂音
因为 有 什么 ， 我 更 什么 的 作文	我 也 有 什么 的 时候 作文	百度 视频 好 还是 什么
时空 猎人 龙 灵 怎么 觉醒 技能	时空 猎人 觉醒 技能 怎么 用	小 青蛙 过河 怎样 过
苹果 手机 微 信 分身 版 怎样 下载	苹果 手机 微 信 分身 版 怎么 下载	微 信 漂流瓶 怎么 无限
日语 ぃ き な り の 什么 意思 ？	日语 と い え ど も 是 什么 意思	大家 都 用 什么 软件 看 漫画
天 猫 猜 品牌 ， 这个 是 什么	苹果 要 那个 国家 出 的 好	什么 手机 视频 播放器 可以 缓存 海贼王
为什么 下载 了 艾 尔 之 光 玩 不了	为什么 下载 了 问道 玩 不了	谁 知道 安徽 卫视 那个 女 主持人 的 名字 ？
图片 是 哪部 动画片	这个 图片 是 哪部 动画片 ？	分式 的 运算 ！
怎样 制作 手工 巧克力 ？	手工 巧克力 怎么 制作 ？	欲 钱 买 壮丁 指 的 是 什么 生肖 ？
请问 您 是 使用 花 呗 付款 的 吗	您 是 想 使用 花 呗 付款 的 吗	经常 吃 面包 好 吗
男生 想 抱 女生 代表 什么	男生 送 女生 抱 枕 代表 什么	您 是 想 使用 花 呗 付款 的 吗
软 妹子 什么 意思	软 妹子 是 什么 意思 ？	问 一下 图片 里 是 哪个 卡通人物 ， 叫 什么 名字
传说 片尾曲 叫 什么	传说 片尾曲 是 什么	请问 各位 ， 这 是 什么 漫画 ？
什么 马 只有 两条腿 ？	什么 马 两条腿 ，	李宇春 有 男朋友 了 吗
男生 如何 自己 剪 刘海	男生 斜 刘海 怎么 吹 ？	什么 饮料 提神 ？
防晒霜 哪个 牌子 好 ？	皮肤 风衣 哪个 牌子 好 ?	推荐 几本 小说 ！
蹉跎 ， 是 什么 意思 ？	蹉跎 是 什么 意思 ？	喜欢 什么 星座 男
求 这个 小 萝 莉 的 名字 ~	求 这个 小 萝 莉 的 名字 !	贴 吧 不 显示 头像
蒸 包子 用 什么 垫 好	什么 叫 包子 萌 ？	您好 ， 我 这边 查询 到 您 的 支付宝 账户 是 没有 问题 的 ， 您 有没有 换 浏览器 试一下 呢 ？
求 一本 女 主 重生 末世 小说	求 末世 系统 末世 重生 完 本 小说	基金 产品 ： 由 基金 公司 发布 的 各类 基金 产品 ， 包括 分级 债 及其 他 类型 基金 产品 。
金华 火腿 怎样 烧 好吃	金华 火腿 怎么 做 才 好吃	电脑 什么 字体 最 好看 ？
美女 掉 衣服 的 ？	怎样 撕 美女 衣服	马 叉 虫 什么 意思 ！
小 超市 进货 怎么 进	超市 怎么 进货 ？ 在 哪里 进 ？	铠甲 勇士 拿 瓦 的 主题曲 叫 什么
记者 可以 用 什么 来 比喻	人们 常 把 记者 比喻 成 什么	我 额头 窄 ， 适合 什么 刘海 ？
网球王子 的 同人小说	网球王子 同人小说 。	小米 主题 怎么 破解 破解
嗯 ， 麻烦 您 了 ， 给 您 带来 的 不便 ， 希望 没有 影响 到 您 的 心情	恩 ， 麻烦 您 了 ， 给 您 带来 的 不便 ， 希望 没有 影响 到 您 的 心情	请 说 ， 小宝 很 高兴 为您服务 ~ < p > < / p >
避孕套 在 哪里 买	避孕套 可以 在 哪里 买	超 拽 超 霸气 不 带 字 女生 头像
武媚娘 末 剪 是 怎样 的 ？	我 的 武媚娘 妆 如何	三 把 刀 车标 叫 什么 车
民政局 星期六 星期天 上班 吗 ？	民政局 星期六 星期天 有 上班 吗 ？	女生 被 草 什么 感觉
什么 的 北风 ？	北风 呼 什么	冻 白菜 怎么 吃
开 汽车 美容店 利润 如何	开 汽车 美容店 的 利润 怎么样	红 萝卜丝 怎么 炒
买 什么 牌子 的 泡 脚盆 好 ？	什么 牌子 洗 脚盆 好	有 谁 知道 什么 好看 的 电影 吗 ？
提供 一下 您 的 时间 与 金额	那 您 提供 一下 金额 和 时间 。	怎样 可以 刷 财富 值
梅花香 自苦寒 来 上 一句 是 什么	梅花香 自苦寒 来 的 上 一句 是 什么 ？	怎么 画 燕子
她 是 杏眼 还是 桃花 眼	桃花 眼 还是 杏眼	我 要 疯 了 咋办 小孩 不 吃饭 怎么办
龙 本命年 戴 什么 好	本命年 带 什么 好 ？	疯狂 英语 杂志 哪里 买
瑜伽 垫 哪个 牌子 比较 好	国内 现在 瑜伽 垫 品质 哪个 品牌 最好 用	武财神 是 谁
大家 知道 什么 好看 的 电影 吗 ？	有 谁 知道 什么 好看 的 电影 吗 ？	求 装饰 包装 设计 公司 广告语
过期 的 身份证 能 买 到 火车票 吗 ？	过期 的 身份证 可以 买 火车票 吗	功夫 派 有 什么 辅助 器 ？ ！ 求 啊
街头 篮球 美 服 代理	街头 篮球 很 卡	这 是 哪部 动画片 的 人物 ？
嘿 ， 你 的 益 达 。	你 的 益 达 呢	如何 提高 自身 的 气质 呢 ？
求 一本 网 王 同 人	求 一本 网 王 同 人 ，	斗地主 有 什么 技巧 ？
女人 如何 保养 自己 的 卵巢	女人 如何 保养 好 卵巢	梦见 抱 别人 小 小女孩
梦 三国 和 英雄 联盟 哪个 好玩	英雄 联盟 和 梦 三国 哪个 更 好玩 ？	为什么 我 支付宝 钱包 里面 没有 花 呗 的 选项
气功 外 气 是否 真的 存在 ？	中国 气功 真的 存在 吗 ？	重生 鸿蒙 类 小说 、
泥鳅 怎么 煮 好吃	泥鳅 怎么 煮 好吃 ？	这 款 面膜 里 含 不 含 激素 ？
踌躇 是 什么 意思	踌躇 是 什么 意思 ？	三元 一次方程 解
什么 牌子 的 加湿器 声音 小	什么 牌子 的 加湿器 最好	枸杞 有 什么 功效
怀孕 三个 月 后 能 做爱 吗	怀孕 前 三个 月 可以 做爱 吗 ？	文思 如 泉 是 什么 意思 ？
烽火 戏 诸侯 的 一些 歌	关于 烽火 戏 诸侯	牙 啫喱 是 什么
爸 的 正确 笔顺 ， 请 写 出来 。	火 的 正确 笔顺	无 房 证明 怎么 开 ？
鲸鱼 为什么 会 搁浅 ？	鲸鱼 搁浅 为什么 舌头 会 吹 泼	如何 快速 美 白 牙齿 ？
什么 单机游戏 最 好玩 是 电脑 的	电脑 上 有 什么 好玩 的 单机游戏 吗 ？	求 一本 小说 是 和 攻 撕 逼 的
知趣 竞猜 品牌 这个 是 什么 ？	知趣 竞猜 这 是 什么 品牌 ！	怎么 让 别人 打 不通 我 的 手机
小 二 这边 核实 到 这个 手机号 是 有 注册 支付宝 账户 的 ， 这个 账户 是 您 注册 的 吗 ？	小 二 这边 核实 到 这个 手机号 是 有 注册 支付宝 账户 的 ， 这个 是 您 注册 的 吗 ？	求 音乐 ： 巴 啦 啦 歌曲
什么 牌子 的 轮胎 好	轮胎 选 什么 牌子	孕妇 补锌 ， 吃 什么 好 ？
佐酒 能量 块 哪里 有 卖 的	佐酒 能量 块 哪里 能 买 到	辽宁 金融 职业 学院 录
手机 有 QQ 胡 莱 三国 小分队 吗	为什么 我 的 胡 莱 三国 小分队 每次 登 入 都 得 重新 设置	， 天上 的 白云 像 什么 ？
长沙 有 什么 好吃 的 ？ 过年 期间 准备 去 吃 。	过年 去 成都 有 什么 好玩 的 ， 好吃 的	… 要 网名 ， 带符号 。
找 一部 旧 爱情 电影	找 一部 爱情 电影	红 岭 创投 网络 理财 靠 谱 吗 ， 真的 很 安全 吗 ?
最新 国产 搞笑 电影 有 哪些 ？	有 哪些 国产 喜剧电影 （ 爆笑 ）	有没有 什么 好玩 的 手机游戏 。
今天天气 好 晴朗 。	今天天气 好 晴朗	喜闻乐见 是 什么 意思 了
星期六 的 英语 怎么 说	星期六 的 英文 怎么 写	在 第 几届 奥运会 上 , 足球 成为 了 正式 比赛项目
想 找 星巴克 的 兼职	想 找 个 能 在家 上班 的 工作 。	功夫 派 为什么 我 不能 变 身
我们 身边 的 科学知识 啊 ~ ！	我们 身边 有 哪些 科学知识	这 悬臂梁 的 剪 力图 和 弯矩 图 怎么 画
买 二手车 需要 注意 什么 ？	买 二手车 都 需要 注意 什么	建议您 联系 一下 银行 客服 核实 一下 银行卡 明细
华硕 手机 如何	华硕 手机 怎么样	北京 有 什么 地方 买 鸟 啊 ? 最好 是 东城 的
球 圆柱 圆锥 有 什么 共同点	圆柱 、 圆锥 、 球 的 共同点 是 什么 ？	当 什么 时候 可以 刮胡子
早上 空腹 喝水 好 吗 - 早上 起来 喝水 有 什么 好处	早上 空腹 喝水 有 什么 好处	短发 适合 什么样 的 脸型
陈 晓 和 赵 丽 颖 是 情侣 吗 ？	张 翰 和 郑 爽 是 情侣 关系 吗 ？	微 信 如何 绑定 新浪 微 博
武汉 找 工作 ， 男 ，	武汉 本地 急 找 工作	为什么 女人 比 男人 还 好色 呢
女人 为什么 比 男人 更好 色	为什么 女人 比 男人 还 好色 呢	你 的 益 达 呢
亲 ， 辛苦 您 可以 在 推送 框 中 输入 一下 身份证 后 8 位 可以 吗	那 可以 麻烦 您 在 推送 框 填写 一下 您 的 身份证 后 8 位 吗	哪里 有 卖 货架 的 ？
邮轮 旅游 一般 要 多少 钱 ？	到 鼓浪屿 旅游 一般 要 花 多少 钱 ？	亲 按照 常理 说 你 既然 找回 成功 了 可能 是 你 输入 的 时候 没有 注意 大小写 的 问题
怎么样 才能 注册 淘宝 帐号	如何 注册 淘宝 帐号	那个 视频 软件 可以 制作 字幕 的 ， 求 高手 指点 !
答题 ： 中国 现当代 文学史	中国 现当代 文学史 笔记	胃药 是 饭前 吃 还是 饭后 吃 ?
喜欢 上 一个 女生 ， 如何 让 她 对 我 有 好感	喜欢 女孩 如何 让 她 对 我 有 好感 ！	求 这个 头像 大 图 ！
想 找 一部 很 好 的 动漫	有 一部 新 动漫 ， 求	手机 淘宝 怎么 修改 评价 ？
怎么 才能 睡着 啊 ！	人 是 怎么 睡着 的	四川 城市 职业 学院 一年 的 学费 是 多少 啊 ？
形容 秩序 好 的 成语 有 哪些	形容 秩序 好 的 成语	欧莱雅 护肤品 怎样
中关村 三 小 几点 放学	中关村 三 小 上课 铃声	关于 爱情 的 网名
兰 岛 物语 少女 的 约定 下载	兰 岛 物语 ( 少女 的 约定 ) 下载	鹰 的 近义词 组词
百合 是 什么 意思	百合 什么 意思	这个 衣服 穿 什么 鞋 和 裤子 好看 呢
如何 学会 沟通	怎么 学会 沟通	你 今天 · 吃晚饭 了 么 ？
网络 上 有 什么 兼职 吗 ？	在 网络 上 有 什么 可以 兼职 的	怎么 让 胡子 长 得 慢点
公安局 开房 记录 保留 多久	开房 记录 在 公安局 保留 多久	社会保障 卡 有 什么 用 ？
东方 神 起 吧 快 闪	东方 神 起 哈哈 颂	木瓜 怎么 做 好吃
问 ： 学 挖掘机 哪家 强 ？	学 挖掘机 ， 到底 哪家 强 ？	怎样 办理 余额 宝 ？
温州 哪里 好玩	温州 哪里 有 好玩 的 …	这 是 什么 动画 ， 叫 什么
解 三元 一次方程	三元 一次方程 解	石家庄 天气 怎样
骂人 越 毒 越 好 。	骂人 的话 ， 越 毒 越 好	问 个 日文 怎么 打
藏蓝色 裤子 配 什么 颜色 上衣	灰色 裙子 配 什么 颜色 上衣	实名 类 交易 （ 如 ： 买 机票 / 火车票 / 彩票 ） 单笔 3 万 、 单日 3 万 、 单月 无 限额
唱 吧 怎么 发起 合唱	唱 吧 怎么 发起 合唱 ？	天 猫 有 这 东西 吗 ？
怎么 用 屏幕 录像 专家 ？	怎么 用 屏幕 录像 专家	账单 导入 成功 ， 可以 在 该 信用卡 还款 页面 点击 该卡 一栏 查看 邮箱 账单 明细 ；
用 一会儿 一会儿 造句	用 一会儿 ， 一会儿 造句	什么 人 只 隔 一夜 就 变 老
燃气 热水器 哪个 品牌 好	燃气 热水器 哪个 品牌 的 好	男朋友 生日 做 什么 菜 好
怎样 让 小腿 变 瘦 、 ？	怎样 可以 让 小腿 变 瘦	男生 送 女生 抱 枕 代表 什么
今天 晚上 吃 什么 饭	今天 晚上 吃 什么 饭 ？	淘宝 上 有 什么 好 的 茶叶 可以 买 ？
天上 的 白云 像 什么 ， 什么	， 天上 的 白云 像 什么 ？	请 详细 解说 谢谢
不识庐山真面目 的 识 是 什么 意思	不识庐山真面目 识 什么 意思	木瓜 的 籽 能 吃 吗 ？
哪个 牌子 的 脱毛膏 好 ？	我 想 知道 哪个 牌子 的 脱毛膏 好	有 什么 中国 特色 的 礼品 可以 送给 泰国 的 小朋友 ?
彩票 网站 哪个 好	哪个 网站 买 彩票 的 人 最 多	谁 推荐 一本 好看 的 小说 啊
中兴 的 手机 质量 怎么样	中兴 手机 质量 怎么样 ？	怎样 自学 高中物理 ， 参加 竞赛
氢氧化铜 和 盐酸 反应 成 什么 颜色 的 溶液	硫酸铜 溶液 和 氢氧化铜 溶液 的 颜色 都 是 绿色 吗 ？	鸟 屎 掉 在 身上 会 怎么样 ？
怎样 手机 截图 ？	手机 如何 截图 ？	怎么 查 衣服 货 号 ？
怎样 能 快速 赚钱 呢 ？	怎样 快速 赚钱 啊 ？	我 的 额头 窄 ， 适合 什么 发型 呢 ？
怎样 查询 驾驶证 扣分 违章	驾驶证 违章 扣分 怎么 查询 ？	李小龙 那么 瘦 怎么 那么 厉害
您 看看 您 的 支付宝 账户 信息 的 页面 的 小 闹钟 是 有 信息 提示 吗 ？	请问 您 是 使用 什么 信息 注册 的 支付宝 账户 ？ 您 可以 提供 一下 报错 页面 的 截图 吗 ？	这 是 什么 剧 的 剧照 ？
日 抛 美 瞳 哪个 牌子 好	美 瞳 哪个 牌子 薄	谁 带 我 打 奥拉 星 圣光 修罗 伙伴 试练
我 的 世界 怎么 造 工作台	我 的 世界 怎么 造 工作台 阿 ！ 详细 点 ， 不然 不 采纳	这 是 什么 品种 的 茶花 ？
谁 有 好看 的 小说 介绍 一本	谁 推荐 一本 好看 的 小说 啊	拉布拉多 和 金毛 区别
银行卡 怎么 改 密码	怎么 改 银行卡 密码	中国 海洋大学 浮山 校区 的 图书馆 藏书 多 吗 ？
神态 描写 成语 愁 ( ) 满 ( )	描写 人 神态 的 成语	木瓜 丰胸 ？ 真的 可以 吗 ？
亚洲 艺术 公园 是 旅游区 吗 ？	投资 亚洲 艺术 公园 好 吗 ？	兼职 是 什么 意思 ？
犹太人 为什么 很 聪明 ？	犹太人 为什么 聪明 电子书	求 这 首歌 的 名字
谁 吃 过 增高药 有用 的 ？	人 肉 好吃 吗 ？ 谁 吃 过	感谢您 的 耐心 等待 ， 麻烦 您 把 收银台 付款 页面 截图 提供 下 ， 辛苦 您 了 。
我 的 脸型 适合 什么样 的 短发 啊	短发 适合 什么样 的 脸型	弹弹 堂 什么 武器 最好
花雕 鸡 是 哪个 地方 的 菜	毛血旺 是 哪个 地方 的 菜	玩 魔 道 在 优 酷 出 视频
我 喜欢 一个 男生 如何 表白 ？	怎样 向 我 喜欢 的 男生 表白	龙虾 怎么 煮 才 不 掉 腿
视频 里 的 歌曲 叫 什么 名字	求 视频 里 的 歌曲 名字 叫 什么	思春 是 什么 意思 ？
请问 您 有 几个 支付宝 账户 ， 这个 账户 中 并 没有 核实 到 您 的 这笔 交易 的 。	对方 账户 是 已经 激活 的 正常 使用 的 账户 的 ， 资金 已经 交易 成功 ， 从 您 账户 支付 的	梦幻 西游 灵隐寺 合 过 区 没 ？
您好 ， 您 不用 担心 这个 问题 ， 到 时 邮件 审核 后 会 有 提示 操作 的	花 呗 目前 系统 更新 维护 ， 稍后 可 恢复正常 ， 请 您 今日 晚些时候 操作 。	哪个 省 美女 最 多 ？
天龙八部 技能 见 了	天龙八部 技能 书	杨 幂 与 刘恺威 怎么 认识 的 ，
怎样 扩大 自己 的 社交圈 ?	如何 扩大 自己 社交圈 ？	支付宝 添加 别人 银行卡 的 问题
淘宝 兼职 能 做 吗	网上 可以 做 什么 兼职	如何 判断 自己 是否是 她 的 备胎
怎么 看 显卡 的 好坏 ？	怎么 看 显卡 好坏 ？	女 的 右 眼皮跳 是 什么 原因 啊 ？
一夫当关 的 下 一句 是 什么	一夫当关 的 后 一句 是 什么	冬天 用 什么 取暖 好
打 豆豆 是 什么 意思 ？	拉 豆豆 什么 意思	您好 ， 是 300 的 这笔 吗 ？
郴州 明星 学校 小学 一年级 一年 学费 是 多少 ?	郴州 明星 学校 高中 寄宿生 一年 要 花 多少 钱 ？	单身 公主 相亲 记 大结局 最后 一段 里 的 插曲 是 什么
依依不舍 的 什么	依依不舍 地 什么	周杰伦 的 现 女友 是 谁
喜 羊 羊 与 灰 太 狼 的 大结局 是 什么	喜 羊 羊 大结局 是 什么 ？	人口密度 是 怎么 算 的
淘宝 盗 图 被 投诉 怎么办	淘宝 卖家 如果 一直 不 发货 会 怎么样	什么 珍珠粉 做 面膜 好
什么 牌子 空压机 好 ？	什么 牌子 的 空压机 好	有 部 电影 叫 什么 名字
显卡 板 是 什么 东西 ？	显卡 是 什么 东西	涨停 前 如何 买入
男生 轻 搂 着 女生 腰 代表 什么	男生 咬 女生 代表 什么	梦见 被 人 追杀
机顶盒 什么 牌子 好	什么 牌子 的 机顶盒 好	篮球 哪里 可以 打气
怎么 使 鼻子 变 高 ？	怎样 鼻子 才能 变 高	微 信 怎样 分享 链接
文房四宝 是 指 哪 四 宝 ？	文房四宝 指 的 是 哪 四 宝 ？	有 什么 好玩 的 单机 手机游戏 没 ？
上海 的 亚历山大 是 个 什么样 的 会 所	关于 上海 亚历山大 会 所	这 是 什么 动漫 还是 游戏
理财产品 有没有 那种 没有 风险 的 ？	信 和 财富 理财 好不好 ？ 有没有 风险	还有 火影 同 人 漫画 吗
功夫 派 为什么 我 回 不了 家园	功夫 派 为什么 我 不能 变 身	请教 一个 高中地理 问题 天气 系统
过年 没 钱 怎么 回家	有钱 没 钱 回家 过年 谁 唱 的	请 大家 推荐 一部 手机 。
姐姐 结婚 ， 送 什么 礼物 好 呢 ？	姐姐 结婚 ， 我 送 什么 礼物 好 啊	鸡蛋 炒 土豆 有毒 吗 ？
敏感 的 反义词 是 什么	敏感 的 反义词 是 什么 ？	跪求 あ ず み 恋 迅雷 种子
您 是不是 要 修改 手机号码 的 呢 ， 亲	我 知道 ， 麻烦 您 具体 是 指 哪个 号码 要 改 呢 ？ 需要 改为 哪个 号码 呢 ？	过程 装备 与 控制工程 专业 怎么样 ？
全民 飞机 大战 外挂 怎么 下载 的	全民 飞机 大战 外挂 怎么 下载 ， 苹果 手机	如何 异地 注销 银行卡
手机 淘宝 如何 修改 评价	手机 淘宝 怎么 修改 评价 ？	龙 男 和 虎 女 配 吗
英雄 联盟 怎么 解封 ！	英雄 联盟 怎么 创建 战队 ？	怎样 找 一本 好书
孕妇 可以 食 草莓 吗 ？	孕妇 草莓 能 吃 吗	广州 花城 广场 有 什么 ， 怎么 去 。
死亡 笔记 动漫 全集 下载	死亡 笔记 电影版 全集 下载	关于 路 的 名言
现在 国家 主席 是 谁	现在 的 国家 主席 是 谁	陈 坤 赵 薇 怎么 了
广西 哪里 有 羊	这里 是 广西 的 哪里 ？	世界杯 什么 时候 会 在 中国 举行 ？
书店 里 买不到 什么 书 ？	书店 里 买不到 的 是 什么 书	计算机 省 一级 证书 对 找 工作 有用吗 ？
免费 可以 看书 的 软件	有 什么 软件 可以 免费 看书 ？	什么 牌子 的 加湿器 最好
好 一点 的 制作 视频 ， 字幕 的 软件	那个 视频 软件 可以 制作 字幕 的 ， 求 高手 指点 !	猜 成语 。 第一个 必 采纳
感冒 的 时候 还 可以 喝酒 吗 ？	得 了 痔疮 还 可以 怀孕 吗 ？	请问 您 是 什么 方式 支付 的 ？
电脑 什么 字体 好看	电脑 什么 字体 最 好看 ？	执意 是 什么 意思 ？
男人 的 精子 进入 女人 身体 会 怀孕 吗 ？	男人 精子 受 女人 哪里 才 会 怀孕	世界 上 最 贵 的 货币 是 什么 币
时空 猎人 怎么 找回 密码 ？	时空 猎人 如何 找回 密码	斗 罗 大陆 武魂 殿 的 所有人
急 ！ 要 分手 后 的 网名 、	… 要 网名 ， 带符号 。	固安 别墅 价格 昼
带 着 避孕套 会 怀孕 吗	带 避孕套 会 怀孕 吗	谦卑 是 什么 意思
梦见 暗恋 的 男生 喜欢 自己	梦见 喜欢 自己 的 男生	步步高 音乐手机 的 主题曲 是 什么 ？
为什么 男人 喜欢 抚摸 女人 的 胸部 ？	男人 为什么 喜欢 胸 大 的 女人 ？	哪里 卖 正宗 的 福建 辣椒 王
肚子疼 但是 不 拉肚子 是 怎么回事	肚子疼 不 拉肚子 是 怎么回事	小草 有 什么 特点 可以 象征 什么
堕落 女 教师 破 壊 }	堕落 女 教师 破 壊	这 是 啥 牌子 的 唇膏
免费 在线 起名	在线 免费 起名	火线 追凶 全集 有 哪 几部
极限 挑战 什么 时候 能 播 呀 。	极限 挑战 什么 时候 播出 在 哪个 台 播	弹弹 堂 敏捷 有 什么 用 …
描写 树木 的 词语 ？	形容 又 懒 又 萌 的 词语	求 主角 长 得 比 女生 漂亮 的 网游 小说 。
什么 手机游戏 最 像 英雄 联盟	掌上 英雄 联盟	什么 大方 成语
谁 教 我 玩 我 的 世界 生存 模式 ？	我 的 世界 生存 模式 鞍 怎么 用	小 二 这边 核实 到 这个 手机号 是 有 注册 支付宝 账户 的 ， 这个 是 您 注册 的 吗 ？
怎么 找 可靠 的 网上 兼职 ，	网上 兼职 可靠 吗 ？	怎么 才能 让 鼻子 变 高
湖南 特产 是 什么 ？	湖南 的 特产 是 什么	营业执照 可以 贷款 吗 ？
生肖 年 是 指 新历 还是 农历 ？	生肖 算 农历 还是 新历	七夕 情人节 送 女朋友 什么 好
带 套 也 会 怀孕 吗	带 套 还 会 怀孕 吗 ？	签名 设计 免费版 在线 ，
什么 牌子 连裤袜 质量 好	什么 牌子 的 女士 连裤袜 质量 比较 好 而且 价格便宜	功夫 派 兔子 用 什么 灵兽 好 ？
什么 东西 人们 都 不 愿意 吃 ？	什么 东西 谁 都 不 愿意 吃 ？	怎样 招 面膜 代理 ？
为什么 我 的 泰拉 瑞 亚 打不开	泰拉 瑞 亚 为什么 打不开	宽慰 什么 意思
用 暴风 影音 怎么 看 黄 ？	暴风 影音 怎样 看 黄 ？	周杰伦 什么 时候 会 结婚
怎么 查询 手机 通话时间	如何 查询 手机 的 总 通话时间 ？	现在 流行 什么 玩具 ？
什么 网站 能 看 新 电影	哪个 网站 可以 看 电影 操 我	古 剑 奇谭 全集 在 哪 看
找 小说 ， 一本 古 言	找 一本 古 言 小说	主观 与 客观 分别 是 什么 意思
江西省 省会 是 哪里 啊	江西省 省会 是 哪里 ？	鲜 桂圆 吃 多 了 容易 上火 吗 ？
木瓜 吃 了 真的 能 丰胸 吗 ？	木瓜 丰胸 ？ 真的 可以 吗 ？	据 的 一声 怎样 组词
请 大家 帮忙 取 一个 好听 的 服装店 名 ！	请 帮 我 取 一个 服装店 名 ， 要 好听 的	中国 气功 真的 存在 吗 ？
衣服 尺码 的 问题	衣服 的 尺码 问题	男人 蹭 女 的 脚 是 什么 意思
关于 厨房 的 风水 书	厨房 在 哪儿 风水 才 好	您好 . 您 的 情况 建议您 使用 更加 稳定 的 阿里 云 邮箱 即 可以 了 .
煮 龙虾 的 蘸 水 怎么 配	龙虾 怎么 煮 才 不 掉 腿	你们 最 喜欢 看 什么 电视剧
怎么 腌 白菜 。	冻 白菜 怎么 吃	求 优 酷 会员帐号 共享
为什么 我 的 手机 支付宝 没有 蚂蚁 花 呗	为什么 我 支付宝 钱包 里面 没有 花 呗 的 选项	求 推荐 好看 的 电影 ！
这个 项链 什么 牌子	这个 项链 是 什么 牌子 ？	华为 手机 相机 相册 一直 闪 打不开
麻烦 您 提供 一下 您 的 身份证 后 八位 ， 从 您 的 生日 月份 开始 算 起 。	麻烦 您 提供 一下 您 身份证 的 末 8 位 ( 从 您 出生 月 . 日 往后 算 起 ) 辛苦 您 的 操作 . \	这么 任性 ？ 什么 意思
大龙虾 怎么 做 才 好吃 ？	活 的 大龙虾 怎么 做 好吃	来自 历史 故事 的 成语 有 哪些
重庆大学 91 级 钢铁 冶金 专业 毕业生 秦军	北京科技大学 钢铁 冶金 专业 怎么样	仙人掌 开花 了 ， 是 好 还是 坏 ？
火灾 时 怎样 逃生	火灾 时 ， 如何 逃生 ？	手机 流量 不能 上网 了
最近 有 什么 好看 的 电影 推荐 ?	最近 有 什么 好看 的 电影 推荐	北京 做 双眼皮 多少 钱 ？
在家 创业 做 什么 项目 好	有 什么 可以 在家 创业 的 好 项目 吗	新 商 盟 烟草 网上 订货
龙 之 牧场 这 是 什么 龙	龙 之 牧场 这 是 什么 龙 ？	掌上 营业厅 江苏 移动 猛击 送 流量 怎么 到 不了 帐户
杨 幂 与 唐 嫣 ， 谁 更 漂亮 ？	杨 幂 和 唐 嫣 谁 最 漂亮 ？	时空 猎人 觉醒 技能 怎么 用
这个 男人 是 什么 意思 ？	男人 蹭 女 的 脚 是 什么 意思	玫琳凯 护肤品 怎么样 ？
胸 怎样 能 变 大 ？	怎么 使 胸 变 大 ？	恋恋不舍 的 舍 的 意思 是 什么
求 监狱 兔 第四季	监狱 兔 还 会 出 第四季 吗 ？	我 知道 ， 麻烦 您 具体 是 指 哪个 号码 要 改 呢 ？ 需要 改为 哪个 号码 呢 ？
有 部 电影 叫 什么 名字 ？	有 部 电影 叫 什么 名字	求 闪 金 镇 的 那 一夜 和 红龙 女王
怎么 才能 查 别人 的 通话记录	怎么 查 别人 的 通话记录	成龙 的 最新 电影 叫 什么 ？
天天 爱 猜 图 五个 字 明星	天天 爱 猜 图 猜 男明星 范 姓 打头 的 三个 字 的 名星	有 什么 好看 的 电影 推荐 一下
您 可以 联系 一下 银行 客服 核实 一下 银行卡 的 明细	建议您 联系 一下 银行 客服 核实 一下 银行卡 明细	求 秋色 之 空 全集 漫画
做梦 家里 盖 牛圈 是 什么 意思	家里 米 生 蛆虫 是 什么 意思	唱 吧 怎么 发起 合唱 ？
分期 购 包括 ： 天 猫 分期 ， 信用卡 分期 ， 花 呗 等等 业务 的	亲 ， 花 呗 设置 分期 是 可以 选择 0 % - 90 % 金额 做 分期 ， 不能 全部 做 分期 。	淘宝 这 是 什么 意思
粤语 如果 怎么 说	粤语 话 怎么 说	我 的 汤姆 猫 下载 。
悲观 是 什么 意思	太 悲观 的 意思 是 什么 ，	为什么 那么 多 明星 吸毒
其实 我 很 爱 很 爱 你	其实 我 也 不 懂	生活 也 是 这样 这样 是 指 什么
淘宝 的 这个 什么 意思	淘宝 这 是 什么 意思	称 亲爱 的 是 什么 意思
海 绿 之谜 的 净 白活 肤 套装 效果 怎么样 啊 ？	深海 之谜 的 护肤品 怎么样 ？	世界 上 最 聪明 的 人 是 谁
铠甲 勇士 拿 瓦 的 片尾曲 叫 什么	铠甲 勇士 拿 瓦 的 主题曲 叫 什么	有 什么 灾难片 好看 啊 。
北极熊 为什么 不吃 企鹅 宝宝 呢 ？	北极熊 为什么 不吃 企鹅 宝宝 ？	支付宝 年度 账单 ， 通讯 类别 是 指 什么
搔头弄姿 是 什么 生肖	( 搔头弄姿 ) 是 什么 生肖 ？	淘宝 上 买 东西 便宜 点 吗 ？ 可信 吗 ？
怎么样 才 知道 自己 的 手机 有没有 被 窃听 偷窥	怎么样 才能 知道 自己 的 手机 有没有 被 人 安装 窃听器	请问 是否 收到 了 审核 失败 原因 的 短信 或者 是 邮件 呢 ？
在 淘宝 上 买 手机卡 是 真的 吗 ？	在 淘宝 买 东西 可以 用 手机卡 付钱 吗 ？	燃气 热水器 排名
这个 是 一个月 的 还款 。	不是 一个月 还 完 的	上海 哪个 区 租房子 最 便宜 ？ 急 } }
中国 有 多少 农民 ？	中国 有 多少 叫 毛泽东	天龙八部 技能 书
淘宝 帐号 如何 注销	怎么样 注销 淘宝 帐号	求 这 张 图片 的 高清 图 无 水印 ！
可以 办 准生证 吗 ？	没有 工作 ， 可以 办 信用卡 吗 ？	这 是 哪部 电影 … 看 图 …
这些 发型 都 叫 什么 名字 ( 如下 图 )	这 是 个 什么 发型 ？ 名字 叫 什么 ？	女人 如何 保养 好 卵巢
宫 洺 为什么 换人	为什么 宫 洺 换人 了	相看 两 不厌 ， 只有 ？ 什么
求 表情图 猜 成语 答案	表情图 猜 成语 ， 求 答案 ！	北京 的 冬天 冷 么 穿 什么 就 可以 了
人生 怎么 过 才 算 完美 ？	谁 做 过 包皮 手术 ？ 发 前后 对比 图片	被 人 说 长 的 二次元 是 什么 意思
这 配置 能 玩 逆 战 吗	这样 配置 可以 玩 逆 战 吗	左 腮 跳 是 代表 什么 意思
中国 哪个 省 美女 最 多 ，	哪个 省 美女 最 多 ？	好 男人 的 标准 是 ，
手机 数据 流量 打开 依然 不能 上网	手机 流量 不能 上网 了	邓 紫 棋 有 一首歌 ， 啊 啊 } 是 什么 ？
为什么 都 喜欢 邓 紫 棋 ？	邓 紫 棋 为什么 总 喜欢 皮 裤	自己 怎么 按摩 前列腺
怎么 查找 别人 手机 位置 ？	如何 查找 手机 位置	街头 篮球 改 能力 怎么 改
电脑 上 什么 软件 可以 赚钱	电脑 有 什么 软件 可以 赚钱	软 妹子 是 什么 意思 ？
洁身自爱 的 动物	日本 车 最 贵 的 车	香港 哪里 买 燕窝
计算机 一级 证书 对 学生 有用吗 ？ 它 有没有 有效期 ？	计算机 省 一级 证书 对 找 工作 有用吗 ？	求 一本 重生 都市 小说
你 最 喜欢 的 电视剧 是 哪部	介绍 部 你 最 喜欢 的 电视剧 。	车牌 怎么 安装
好看 的 都市 异能	都市 异能 小 说完 本 的	有 什么 好看 的 篮球 电影 和 好 听的歌 吗
有 什么 排毒 的 产品 啊	排毒 什么 产品 好	狗狗 晕车 怎么 看 它 好 与 坏
请问 这 是 什么 漫画	请问 这 是 什么 漫画 的 ？	交通银行 信用卡 的 人工 号码 是 多少 啊
求 云南 的 朋友 进来 帮 我 解答 下 这 句 话 是 什么 意思	求 云南 的 大神 帮 我 解释 下 这 句 话 是 什么 意思 嘛 !	从 五角场 到 大宁 灵石 公园 怎么 走 ？
帮 我 给 宝宝 起 个 乳名 ， 男孩 。	给 宝宝 起 个 乳名 是 个 男孩	爱情 里 没有 谁 对 谁错 ？
赛尔 号 闪光 皮皮 怎么 抓	赛尔 号 闪光 皮皮 怎么 抓 ？	手机 屏幕 破 了 ， 换 个 多少 钱 ， 贵 吗
贴 吧 图片 问题	关于 一些 图片 的 问题	请 帮 我 找 一个 可爱 的 个性 签名
什么 电视剧 好看	有 什么 好看 的 电视剧	如何 对付 职场 小人 ？
金 巴利 陶瓷 玻 化 转 有没有 8121 这个 型号	金 巴利 陶瓷 怎么样 ？	重庆 哪里 能 滑雪
怎么 在家 坐 着 也 能 赚钱 啊	在家 怎么 赚钱 ？	求 头像 ， 高清 大 图
回民 为什么 不吃 猪肉 ？	为什么 回民 不吃 猪肉	当 伴郎 穿 什么 ？
老人 手机 什么 牌子 好	老人 手机 什么 牌子 的 好 ?	我 的 世界 中文版 下载 ，
七龙珠 有 剧场版 吗 ？	七龙珠 还有 剧场版 吗 ？	如何 彻底 删除 朋友圈
微波炉 怎么 考 面包	怎么 用 微波炉 做 面包	在家 带 孩子 。 想 兼职 。
为什么 我家 耳机 有 杂音	为什么 我 的 耳机 输出 低音 时会 有 杂音	这样 配置 可以 玩 逆 战 吗
可以 用 手机 话费 充值 支付宝 吗 ？	可以 用 手机 话费 充值 支付宝 吗	辛苦 您 查询 一下 您 购买 的 理财产品 合同 上面 会 显示 联系方式 ， 辛苦 您 了 。
时空 猎人 在 多 酷 版 在 哪 下载 ？	时空 猎人 多 酷 版 在 哪 下载	犹太人 为什么 聪明 电子书
短 牛仔裤 配 什么 鞋子 好看 ？	牛仔裤 配 什么 鞋子 好看 ？	把 钱 先 用 充值 的 方式 充值 到 支付宝 账户 余额 然后 您 再 操作 进行 付款
什么 歌 最 适合 情人节 ？	什么 歌 适合 做 手机 铃声 女生 用 ，	淘宝网 上 买 的 东西 可靠 吗 ？ 东西 质量 怎样 ？
部落 冲突 更新 不了 了 ， 怎么办	部落 冲突 更新 没有 账号 怎么办	今天 晚饭 吃 什么 呢
如何 查 衣服 货 号	怎么 查 衣服 货 号 ？	有 什么 工作 适合 在家 带 孩子 做 的
请 帮 我 翻译 一下 。 谢谢 ！	翻译 一下 这个 吧 … 谢谢	马尾辫 怎么 梳 好看
建议您 后续 关注 一下 状态 的 ， 麻烦 了 。	建议您 把 交易 记录 删除 一下 ， 重新 建立 交易 操作 的 ， 麻烦 了 。	什么 牌子 的 米粉 好
侠盗 飞车 罪恶都市 修改器 ？	侠盗 飞车 修改器 罪恶都市	婴儿 手推车 多少 钱 婴儿 手推车 什么 牌子 好 啊 ? 谢谢 啦
站 着 总是 腿 抖 是 怎么回事	总是 掉 网 怎么回事	什么 牌子 的 面膜 好 用
怎么 在 电脑 上 给 手机 发短信	从 电脑 上 怎么 给 一个 手机号码 发短信 ？	么 做 的 ， 填 大于号 和 小于号
照片 怎么 做成 视频 ？	怎样 把 照片 做成 视频	按键精灵 后台 代码 求助
这 是 哪 种类 的 石头	图片 中 的 是 哪个 建筑 ， 在 哪里	我 这 是 什么 脸型
玫琳凯 护肤品 怎么样	玫琳凯 护肤品 怎么样 ？	这 张 图 的 高清 大 图
主角 是 小孩 的 小说	求 一本 小说 是 和 攻 撕 逼 的	用 视频 可以 玩 的 游戏 从 哪里 下载 ？
手机 淘宝 店铺 怎么 装修 呀 ？	淘宝 手机 店铺 怎么 装修 ？	怎么样 让 眼睛 消肿 ？
台州 职业 技术 学院 和 浙江 旅游 职业 学院 哪个 好 ？	杭州 科技 职业 技术 学院 和 浙江 旅游 职业 学院 哪个 好 ?	热火 能 夺冠 么
羊 爸爸 和 鸡 妈妈 生 羊 宝宝 好 吗	虎 妈妈 兔 爸爸 生 羊 宝宝 好 吗	虎 求 百兽 而 食 之 ， 得 狐 。 意思 是 什么
做 淘宝 代理 怎么样	淘宝 代理 怎么 做	求 这个 小 萝 莉 的 名字 !
薏米 粥 能 天天 喝 吗	薏米 粥 可以 天天 喝 吗	梦见 开车 压 在 牛 屎 上
大学 什么 专业 好 就业 呢	大学生 就业 什么 专业 好找 工作	橙 光 游戏 制作 封面
脱毛 最好 方法 是 什么 ？	什么 方法 脱毛 效果 最好	大家 觉得 跑 男 好看 吗 ？
热水器 什么 牌子 的 好	热水器 用 什么 牌子 好	这 蘑菇 有毒 吗 ？
什么 软件 可以 用来 做 头像 ？	萌 头像 的 软件 是 什么	有 什么 可以 在家 创业 的 好 项目 吗
苹果 手机 如何 解 网络 锁	苹果 手机 的 网络 怎么 开	给 姓 全 的 男生 起 外号
怎么样 做 对 颈椎病 好 ？	颈椎病 怎么 治 ？	自由自在 是 什么 然
求 这 张 图片 的 高清 壁纸 图	谁 有 这 张 图片 的 高清 壁纸 ？	踏步机 什么 牌子 好 ， 踏步机 品牌 排行
三国 战记 哪里 可以 下载	三国 战记 哪里 有 下载 ？	如何 上传 文件 到 百度
奥特曼 最强 是 谁 ？	最强 的 奥特曼 是 谁 ？	猪 是 怎么 交配 的
怎么 取消 淘宝 的 快捷 支付	淘宝 怎么 取消 快捷 支付	解酒 方法 喝 什么 水
分手 后 还 能 做 朋友 吗	分手 还 能 做 朋友 吗	极限 挑战 什么 时候 播出 在 哪个 台 播
手机 里 怎么 找回 支付宝 密码 ，	我 的 支付宝 密码 在 手机 上 怎么 找回	终极 宿舍 什么 时候 更新
时间 煮 雨 谁 唱 的 ？	时间 都 去 哪儿 了 是 谁 唱 的 ？	空调 啥 牌子 最好
文章 的 老婆 是 马伊利 吗 ？	文章 和 马伊利 是 怎么 认识 的	不 一样 的 美男子 会 不会 有 第二部
面膜 有 什么 功效	枸杞 有 什么 功效	谁 做 过 包皮 手术 ？ 发 前后 对比 图片
创新 智慧 城市 发展 模式 PPP 有 何 值得 学习	城市 发展 模式	这个 系列 的 漫画 叫 什么 名字 ？
在 天 猫 买 东西 靠 的 住 吗	天 猫 有 这 东西 吗 ？	这 是 哪个 国家 钱
因为 电脑 上面 有 【 通过 人工 服务 】 的 找回 方式 ， 手机 上面 没有	因为 电脑 上面 有 【 通过 人工 服务 】 找回 方式 ， 手机 上面 没有	中关村 三 小 上课 铃声
世界杯 好玩 不	全民 足球 好玩 不 ？	手机 如何 截图 ？
有关 孙悟空 的 成语	关于 孙悟空 的 成语	马铃薯 就是 土豆 吗 ？
鸽子 都 配对 下蛋 了 现在 怎么 又 打架 了	小 鸽子 出 了 一个月 老 鸽子 还 不 下蛋 为什么	闺 蜜 结婚 送 什么 礼物 好 啊
怎么 杀 魔鬼	征途 天马 怎么 得	您 现在 先 试试看
万能钥匙 怎样 下载	怎样 下载 万能钥匙	如何 画 荷花
请问 送 什么 东西 ？	请问 这 东西 有 什么 用 ？	如何 才能 告别 单身 ？
紫菜 头 什么样 是 坏 了	全身 没 力气 是 怎么回事	性生活 是 什么 感觉 啊 ？
呼呼 是 什么 意思 ？	卡 呼呼 什么 意思	喝 白酒 后 吃 什么 好
日语 可爱 怎么 打	日语 可爱 怎么 说 ？	天空 为什么 是 蓝色 的 ？
果 果 是 什么 意思 ？	果 果 什么 意思 ？	到 美容院 做 护肤 其实 好不好 ？
什么 牌子 面膜 补水 好	什么 牌子 的 面膜 最 补水 ？	你 最 喜欢 的 一句 话 是 什么 ？
怎么 才能 在 百度 上 发帖子	怎么 在 百度 贴 吧 发帖子 急	食品科学 与 工程 出国 读 研究生
深圳 龙华 富士康 招工 吗 ？	深圳 龙华 富士康 集团 还 招 人 吗 ？	怎么样 使 自己 的 衣服 变 香 啊
现在 流行 什么 颜色 的 头发	现在 流行 染 什么 颜色 的 头发	北京站 是 哪个 区
人 的 命运 是 天 注定 的 吗 ？	日本 人 是 人 吗 ？	什么 牌子 的 护手霜 好 啊 , 最好 是 不 太贵 的
气吞山河 是 指 什么 生肖	气吞山河 是 什么 生肖	女孩 的 名字 叫 姚 什么 菲
手机 支付宝 怎么 把 钱 转入 到 余额 宝	怎么 把 手机 支付宝 的 钱 转 到 余额 宝	电脑 玩 游戏卡 的 很
四川 老乡 过年 拼 车 回家	拼 车 回家 过年 拉	依依不舍 地 什么
什么 牌子 的 电视 盒子 比较 好	什么 牌子 的 电视 盒子 好	！ 仔细 的 反义词 是 什么
怎样才能 赚 到 更 多 的 钱	怎样才能 去 斑 。	求 银 魂 的 同人小说 。
急 } } 兄妹 契约 ，	手机 铃声 啦 啦 啦 啦	给予 是 快乐 的 是 什么 意思 啊
飞车 里 怎么 离婚 啊 ？	飞车 离婚 怎么 离 ？	那 您 只能 是 用 邮箱 注册 了
吃 什么 可以 让 头发 增多	吃 什么 能 增多 头发 ？	这 是 什么 木头 的
今年 流行 什么 颜色 服装 颜色	今年 衣服 流行 什么 颜色	孕妇 可以 戴 耳机 听 音乐 吗 ?
帮 您 创建 受理 单 人工 审核 找回 您 看 可以 吗	人工 受理 要 上传 证件 ， 48 个 小时 受理 ， 加急 是 4 个 工作 小时 受理 ， 您 看 可以 吗 ？	怎么 能 长 眉毛 ？
是 的 。 可以 提前 还款 ， 也 可以 自动 还款 的 。	查询 您 的 话费 卡 充值 时 您 是 选择 错误 面额 所以 需要 您 等待 三天 恢复 的	神马 都 是 浮云 什么 意思
麻烦 您 说 具体 您 的 问题 ， 我 才 好 帮 您 解决问题 ， 谢谢	您好 ， 亲爱 的 客户 ， 谢谢 给 小 二 服务 您 的 机会 ， 麻烦 您 说 一下 您 的 问题 ， 谢谢您 。	仙人掌 类 的 蚧 壳 虫 怎么 治
是不是 所有 的 面膜 都 含有 激素 呢 ？	这 款 面膜 里 含 不 含 激素 ？	微 信 表情 代表 什么 意思
求 银 魂 同人小说 ！	求 银 魂 的 同人小说 。	中国 自己 的 品牌 有 哪些
孕妇 可以 吃 猕猴桃 吗	孕妇 猕猴桃 能 吃 吗	这个 游戏 名字 叫 什么
疯狂 猜 图 答案	疯狂 猜 图 的 答案	避孕套 可以 在 哪里 买
英语 学习 网站 哪个 好 ？	英语 学习 网站 哪个 好	妈 蛋 什么 意思
如何 快速 让 头发 生长	怎么样 让 头发 快速 生长 ？	求 这 两部 电视剧 的 名字 谢 啦 }
什么 是 刷 票 ？	刷 票 刷 出 什么 了	微 信 朋友圈 怎么 一次性 删除
老婆 生日 送 什么 礼物 ？	老婆 生日 送 什么 礼物 好 啊	大 东 女鞋 加盟 怎么样
手机 通讯录 如何 备份 。	手机 通讯录 如何 备份 ?	世界 第三次 世界大战 爆发 ， 有 这种 可能 吗 ？
爱 用 日语 怎么 写	我 对 你 的 爱 用 日语 怎么 说	狗狗 的 品种
情人节 给 老婆 送 什么 礼物 好	情人节 送 什么 礼物 给 老婆	想 问 一下 这个 石头 有没有 收藏 价值 ？
辽宁 职业 学院 宿舍	辽宁 金融 职业 学院 录	同桌 的 你 电影 完整版 哪里 可以 看
感冒 了 可以 吃 香蕉 吗	感冒 能 吃 香蕉 吗 ？	截然不同 的 意思 是 什么
很 抱歉 ， 花 呗 不 支持 信用卡 还款 的 。	很 抱歉 给 您 带来 不便 了 ， 花 呗 业务 目前 仅 邀请 部分 用户 体验 花 呗 服务 。	淘宝 卖家 如果 一直 不 发货 会 怎么样
鲁智深 的 绰号 是	冲动 是 魔鬼	如何 去 德国 留学 ?
好看 的 都市 玄 幻 小说	好看 的 玄 幻 都市 小说	有 什么 好听 的 外号 吗 ？
沭阳 是 江苏 哪个 市 的	江苏 沭阳 属 哪个 市	部落 战争 ， 怎样 更新
有 什么 网站 提供 日文 原版 轻 小说 下载 ， 带 插图	跪求 北京 哪里 能 买 到 日文 原版 的 轻 小说 ？ 自己 看 分	拼 车 回家 过年 拉
什么 祛斑 产品 效果 好 ?	什么 祛斑 的 产品 效果 好	山西 工商学院 怎么样 ？
用 电脑 上 百度 贴 吧 怎么 设置 小尾巴 ~	百度 贴 吧 小尾巴 怎么 设置	八年级 上 物理 沪 粤 版 练习册 答案
死神 同 人 漫画	能 给 我 火影 同 人 漫画 吗	麻烦 您 提供 一下 报错 的 页面 截图 ， 辛苦 您 了
给 姓 王 的 男朋友 起 外号	给 姓 全 的 男生 起 外号	芯 漾 面膜 怎么样 ？ 好 做 么 ？
宋朝 开国 皇帝 是 谁 ?	宋朝 开国 皇帝 是 谁	嗯 ， 麻烦 您 了 ， 给 您 带来 的 不便 ， 希望 没有 影响 到 您 的 心情
日本 为何 敢 侵略 中国	日本 侵略 过 中国 几次	关于 上海 亚历山大 会 所
求 i 这 张 图片 的 情侣 头像	求 这 张 头像 的 情侣 图片	当 干部 为了 什么
《 中国 大 历史 》 读后感	中国 大 历史 全集 - 黄仁宇 . txt	为什么 我 乳房 那么 小
请问 有人 能 帮 我 把 红底 照片 ps 成 蓝 底 么 ？ 急用 谢谢	能 不能 把 蓝 底 照片 帮 我 改成 红底 的 呀 ？	人 与 动物 最大 的 区别 是 什么
微 信 怎么 截图 聊天记录	微 信 如何 截图 聊天记录	大陆 女明星 谁 最 漂亮
为什么 我 的 手机 不能 打电话 了 ？	为什么 我 的 手机 不能 接 打电话 了	猫 和 老虎 有 什么 关系 ？
承诺 的 意思 是 什么 ？	承诺 是 什么 意思 ？	功夫 派 给 个 号
建议您 让 账户 持有者 本人 来访 的 ， 麻烦 了 。	请 您 让 账户 持有者 本人 来访 的 ， 麻烦 了 。	时空 猎人 腾讯 版 怎么 刷 vip
中国 有 么 有 航母	中国 的 航母 停 在 那	因 周六 周日 不 属于 工作日 所以 建议您 耐心 等待
梦见 被 鬼 追杀	梦见 被 人 追杀	在 网上 可以 做 什么 工作 ， 赚钱
植物 大战 僵尸 破解版	植物 人 大战 僵尸 破解版	根据 视图 ， 补 画 第三 视图
所有 游戏 都 登陆 不 上去 ， 但是 网页 能 打开	为什么 腾讯 所有 的 网页 游戏 都 上 不 去 了	能 给 我 一个 仙 珍 园 邀请 码 吗 谢谢 了
怎么 除 汗毛 ？	怎么 能 长 眉毛 ？	张 翰 和 郑 爽 是 情侣 关系 吗 ？
求 网游 小说 ， 那种 帮 战 少 的 ， 女生 看	求 主角 长 得 比 女生 漂亮 的 网游 小说 。	怎么 销售 鞋子
夜宵 该 吃 什么 好 ？	夜宵 吃 什么 内 ？	淘宝 子 账号 怎么 添加 在 网页 上
咫尺 为 邻 是 什么 意思	远 在 咫尺 什么 意思	怎样 向 我 喜欢 的 男生 表白
怎样 去 销售 卖 鞋子	怎么 销售 鞋子	天天 飞车 ， 怎么 拿 高分 。
筝 字 开头 的 成语	俗 的 反义词 并 和 俗 组成 成语	送 女朋友 什么 生日礼物
WK 到底 是 什么 情况 ， 什么 意思 啊	先 说明 触礁 是 什么 意思 ， 什么 情况 没 危险	联合国 秘书长 潘基文 是 哪 国人 ？ 具体 的 资料 ？
冬天 用 什么 取暖 好 ？	冬天 用 什么 取暖 好	自找苦吃 的 地方 是 哪儿
我 发现自己 不会 和 别人 聊天 了 ， 怎么办	我 太 内向 ， 不会 与 别人 聊天	怎么 用 微波炉 做 面包
天天 酷 跑 怎么 得 钻石	天天 酷 跑 怎么 冲 钻石	有 哪些 时尚 的 新年 祝福语
什么 出 洞 - - 东张西望	什么 出 洞 东张西望	四海为家 的 意思 是 什么
我 没事找事 可以 吗 ？	这 不是 没事找事 嘛	您好 . 请问 您 的 这个 是 163 . 126 还是 QQ 的 邮箱 .
北京烤鸭 哪里 好吃	北京烤鸭 哪里 好吃 ？	朋友 过生日 送 他 什么 歌
不 收费 的 婚恋 网站 有 吗 ？	请问 有 不 收费 的 婚恋 网站 吗	网 银 和 支付宝 一样 吗
如何 让 员工 服从	如何 让 员工 服从 ？	坐 办公室 的 ， 适合 喝 什么 茶
求 那种 小说	那种 色 的 小说	我 想 下载 酷 狗 音乐
您 的 退款 是 成功 了 吗	那 您 就是 还款 成功 了	怎么 才能 使 网速 变 快
有钱 就 任性	有钱 就是 任性 ，	中国 南 车 股票 怎样 ？
求 有关 票务 人员 的 年终 工作 报告 范文 ， 急 ！	求 大神 帮忙 ， 有关 会计 ， 工作 的 ，	打 酱油 的 是 什么 意思 啊
福建 辣椒 王 哪里 买 才 最 正宗	哪里 卖 正宗 的 福建 辣椒 王	陈世美 是 什么
寒冬腊月 指 什么 生肖	寒冬腊月 。 指 什么 生肖	在 杭州 找 工作 去 那里 找
怎样 炒 米粉 好吃	米粉 怎么 做 好吃	十二生肖 都 是 什么
蔡康永 说话 之 道	蔡康永 的 说话 之 道	男人 喜欢 女人 吻 什么 地方
情人节 是 男生 送 女生 礼物 么	情人节 女生 送 男生 礼物 吗	您 点击 详情
网上 订票 后 什么 时候 取 票 ？	网上 订票 什么 时候 可以 取 票	护士 的 职责 是 什么
辛苦 您 按照 上述 的 步骤 操作 更改 手机号码 的 ， 辛苦 了 。	您好 ， 辛苦 您 按照 上述 的 步骤 操作 一下 重置 支付 密码 的 ， 麻烦 了 。	这个 季节 吃 什么 水果 好 ？
求 新浪 微 博 的 新版 邀请 码	求 腾讯 微 博 邀请 码 一个	求 比值 ， 怎么 做
爱 钱 的 动物 是 什么 生肖	爱哭 的 动物 是 什么 生肖	茶杯 犬 合肥 哪里 有 卖 的 ？ 多少 钱 一只 ？
白 衣服 上 的 锈 ， 怎么 可以 去掉	衣服 上 的 胶 怎么 能 去掉	为什么 我 的 小米 手机 总是 在 后台 自动 下载 垃圾 软件
买手机 买 什么 品牌 的 啊	买手机 买 什么 牌子 的 好 .	这个 已经 注册 过 支付宝 账户 的 邮箱 无法 再 注册 其他 的 账户 的 ， 很 抱歉 。
如何 做好 网络营销 呢	怎么 做好 网络营销	本溪 地图 哪里 买
要 这个 字 怎么 写 连笔 字 好看 点 就 行	祚 的 连笔 字 怎么 写 才 好看	情不自禁 的 禁 是 什么 意思 呢 ？
不 一样 的 美男子 还 出 第二部 吗	不 一样 的 美男子 会 不会 有 第二部	寒冬腊月 。 指 什么 生肖
怎么 网上 转账	网上 怎么 转账 ？	伊利 奶粉 怎么 积分
吃豆腐 是 什么 意思 ？	脚底 垫 豆腐 是 什么 意思	什么 牌子 洗 脚盆 好
喜欢 搬弄是非 的 人 — ？	喜欢 搬弄是非 的 人 是 什么	【 看 图 猜 成语 】 请问 这个 是 ？
这 是 什么 剧照	这 是 什么 剧 的 剧照 ？	谁 知道 这 妹子 是 哪部 动漫 的
篮球 为什么 可以 不 打气	篮球 哪里 可以 打气	广东 石油化工 学院 学校 风景
亲 ， 您 的 账户 已经 通过 认证 了 ， 是 不能 再 修改 账户 的 身份 信息 的	这边 查询 这个 支付宝 账户 已经 认证 了 ， 您 有 身份 信息 修改 过 吗	从此 了 无 牵挂 什么 意思
多么 痛 的 领悟 ！	多么 痛 的 领悟 。	什么 软件 可以 用 手机 拍 视频
贴 吧 头像 不 显示	贴 吧 不 显示 头像	哈尔滨 游乐园 在 那
我 是 歌手 第二季 冠军 是 谁	我 是 歌手 第二季 冠军 会 是 谁	小米 手机 好不好
产后 怎样 减 肚子	刨 腹 产后 怎样 瘦 肚子	我 的 南方 与 北方
杨万里 是 什么 朝代 。	杨万里 是 什么 朝代 的 人	现在 都 用 什么 软件 看 电影
关于 校园爱情 片 的 电影	校园爱情 微 电影 有 哪些	如何 取消 支付宝 实名 认证 ？
广州 搬家 哪家 便宜	广州 搬家 公司 哪家 便宜	吃 什么 东西 可以 排毒 ？
灌肠 怎么 做	灌肠 器 怎么 用	中国 最 美丽 的 地方 再 那里
西瓜 地里 散步 — 打 一 谚语	西瓜 地里 散步 , 打 一 谚语	用 什么 方法 减肥 最快 ？
男士 手表 什么 牌子 的 好	什么 牌子 的 手表 好 ， 男士 的	苹果 手机 的 网络 怎么 开
这个 主持人 叫 什么 名字 ？	这个 主持人 人 叫 什么 名字 ？	这个 表情 是 什么 意思 ？
郑州 什么 时候 会 下雪 啊 ？	郑州 什么 时候 下雪 ？	人 的 生命 为什么 很 脆弱
城管 打人 算不算 犯法 ？	城管 打人 事件 党中央 是否 参与	过年 前 什么 时候 送礼 ？
需要 您 提供 身份证 + 付款 凭证 ， 付款 凭证 需要 登录 付款 的 支付宝 账户	您好 ， 因为 找回 密码 是 需要 您 提供 资金 凭证 的 ， 如果 无法 提供 是 无法 找回 密码 的	开房 记录 在 公安局 保留 多久
月经期 可以 喝 红酒 么	月经期 能 喝 红酒 吗 ？	手机 哪个 播放器 能 缓存 电影 ， 而且 电影 电视 很多
这个 兔子 的 名字 是 什么	给 我 这个 兔子 起 名字	你 最 喜欢 《 奔跑 吧 ， 兄弟 》 中 的 谁 ？
是 什么 意思 ， 关于 作文 的	作文 是 什么 意思	三星 s5 怎样 关闭 开发者 模式
求 一部 很 老 的 国产电影	求 一部 国产电影	天天 酷 跑 怎么 玩 不了
不同 产品 的 风险 不 一样 ， 各 产品 的 风险 提示 具体 详见 见 产品 详情页 。	基金 产品 ： 由 基金 公司 发布 的 各类 基金 产品 ， 包括 分级 债 及其 他 类型 基金 产品 。	您好 ， 请问 您 使用 的 邮箱 类型 是 ？
在 办公室 适合 养 什么 花 ？	坐 办公室 的 ， 适合 喝 什么 茶	如何 学习 好 摩斯 密码
怎么 在 网上 订 飞机票	如何 在 网上 买 飞机票	我 想 找 一本 小说 名字 叫 什么 骨
电视剧 怎么 下载 到 手机 上 啊 ？	怎么 把 电视剧 下载 到 手机 上	形容 都 很 臭 四个 字 词语
广州 和谐 医院 如何	广州 和谐 医院 怎么样 ？	多么 痛 的 领悟 。
哭 多 了 眼睛 肿 怎么办	吃 肉 后 身上 肌肉 疼 怎么回事	淘宝 店铺 装修 欢迎光临 怎么 做
结婚 穿 什么 衣服 好	结婚 穿 什么 衣服	淘宝 代购 怎么样 ？ 是 正品 吗 ？
如何 设置 贴 吧 头像 ？	如何 设置 贴 吧 头像	监狱 兔 还 会 出 第四季 吗 ？
什么 丰胸 产品 真的 有效	有 什么 丰胸 产品 是 真的 有效 的	我 的 电子称 怎么 修 ？
谁 给 刘德华 喝 了 忘情水 ？	忘情水 是 谁 给 刘德华 的	可以 用 手机 话费 充值 支付宝 吗
武媚娘 传奇 片尾曲 叫 什么	武媚娘 传奇 的 片尾曲 是 什么 ？	这 是 什么 牌子 的 书包
请 详细 解说 ， 谢谢 。	请 详细 解说 谢谢	榆林 是 哪个 省 的
世界 上 最 贵 的 货币 是 什么 ？	世界 上 最 贵 的 货币 是 什么 币	您好 ， 请 您 核实 一下 其他 的 账户 是否 有 的 。 辛苦 您 了
什么 品牌 的 裤子 好 穿	什么 品牌 的 裤子 好	全民 枪战 怎么 得 钻石
有 什么 好看 的 玄 幻 小说 吗	有 什么 好看 的 玄 幻 魔法 小说 么	在 广州 哪里 可以 摘 草莓
沐浴露 该 用 什么 牌子 的 好 呢	什么 牌子 的 沐浴露 好 ！	怎么 写 好作文
关于 兔子 的 所有 动画片	兔子 的 动画片	美国 一个 搞笑 电影 、
什么 牌子 的 踏步机 好 ？	踏步机 什么 牌子 好 ， 踏步机 品牌 排行	堕落 女 教师 破 壊
这 是 那个 国家 的 钱币 ， 值 多少 钱 ？	这 是 钱币 吗 ？ 是 哪个 国家 的 ？	什么 出 洞 东张西望
创意 生日礼物	有 创意 的 生日礼物	全民 飞机 大战 外挂 怎么 下载 ， 苹果 手机
哈尔滨 游乐园 在 哪个 区	哈尔滨 游乐园 在 那	怎么样 才能 让 自己 更 强壮 ， 更 有 力气
怎么 把 自己 的 信息 发布 到 网上 ，	怎样 发布 信息 到 网上	湖南 科技 大学 热门 专业
爱 一个 人 很 累	韩国 人 很 讨厌 日本 人 吗	哪里 有 鸡婆 店
有没有 好看 的 韩国 青春 电影	有没有 好看 的 韩国 电影	怎么 在 网上 找 资料 ？
吹泡泡 水 怎么 做 ？	吹泡泡 水 怎么 做	今年 头发 什么 颜色 最 流行 ？
在 哪里 可以 找回 账号	支付宝 账号 在 哪里 看	为什么 身份证 会 被 禁用 ？
这 张 我 的 照片 怎么样 ？	谁 见 过 杨 幂 的 这 张 照片 ？	过氧化钠 的 电子式 怎么 写 ？
你 转账 的 金额 是 多少	多少 金额 的 呢 亲 帮 您 核实 一下	校园爱情 微 电影 有 哪些
浙江 旅游 职业 学院 怎么样 ？ 好不好 ？	身高 153 ， 可以 读 浙江 旅游 职业 学院 吗 ？	这种 头发 的 颜色 是 什么 ？
怎么 训练 狗狗 不 咬 人	怎样 才 睡觉 不 做梦	大家 帮忙 看 下 这 是 什么 狗
如何 修改 百度 账号 昵称 ？	怎么 修改 百度 账号 的 昵称 ？	三星 7562 手机 怎么 下载 新浪 天气 小组 插件
干 鳄鱼 肉 怎么 吃	怎样 宰 鳄鱼 龟	苹果 手机 怎么 买 天天 酷 跑 钻石
河北 嵩山 少林 武术学校 怎么样	郑 大 与 嵩山 少林 武术 联办 的 学校 咋样	易 付 宝 支付 密码 忘记 了 怎么办 ？ 0591 - 88581898
这个 是 什么 颜色	镁 锭 什么 颜色	厨房 在 哪儿 风水 才 好
鸡蛋 滚 脸 有 什么 好处	去 了 皮 的 煮 鸡蛋 滚 脸 有 什么 好处	请 您 放心 ， 资金 已经 退回 给 您 了
略胜一筹 的 胜 什么 意思	学 而 时 习 之 的 之 什么 意思 ？	胃 上面 是 什么
世界杯 什么 时候 在 中国 举行 ？	世界杯 什么 时候 会 在 中国 举行 ？	韩国 人 很 讨厌 日本 人 吗
您 把 收支 明细 截图 给 我 看 下 的	您好 ， 是 帮 您 代付 人 的 收支 明细 截图 提供 给 您 ， 您 在 操作 上传 找回 支付 密码 即可	世界 有 神仙 吗 ？
怎样 关闭 开发者 模式 ？	三星 s5 怎样 关闭 开发者 模式	英雄 联盟 怎么 创建 战队 ？
求 驾校 广告语	求 驾校 类 广告语	全身 没 力气 是 怎么回事
梦幻 西游 好玩 嘛 ？	梦幻 西游 好玩 吗	有 什么 好听 伤感 歌 吗
头发 长 虱子 怎么 ，	头发 上 有 虱子 怎么 治	大家 给 推荐 一部 好看 的 电视剧
你 。 海参 怎么 吃 ？	海参 怎么 吃	传奇世界 哪里 爆 屠龙刀 ？
老公 过生日 做 什么 菜 可以 不	老公 过生日 做 什么 菜 好 吗	黑人 的 生殖器 为什么 那么 长
女生 被 阿鲁巴 什么 感觉	女生 被 草 什么 感觉	天天 酷 跑 角色 哪个 最好
财神 猜 一 生肖	财神 送来 四 五六 猜 一 生肖	我 手机 拨号键 找 不到 了
老虎 是 什么 动物	什么 动物 吃 老虎 呀 ？	您 订单 类型 选择 理财 订单
蘑菇 街 可以 货到付款 吗	蘑菇 街 是 货到付款 吗	哪个 网站 买 彩票 的 人 最 多
哈 奇 小镇 萤火虫 抓 不了	哈 奇 小镇 进不去	关于 烽火 戏 诸侯
有 什么 好看 的 鬼片	什么 鬼片 好看	平行四边形 的 性质 有 那些
这 条 裤子 是 什么 牌子 的	谁 知道 这 条 裤子 是 什么 牌子 的 啊	我 的 世界 钻石 长 什么样
高富帅 有 什么 标准 吗	高富帅 、 白 富 美 标准 是 什么 ？	什么 毒 无色 无味 …
我 老公 天天 都 要	为什么 老公 天天 碰 我	法国 和 洪都拉斯 哪个 赢得 几率 大 ？
矿泉水 面膜 怎么 做	矿泉水 莹 透 面膜 怎么 涂	这个 季节 去 哪里 好玩 ？
支付宝 转入 可以 用 别人 名字 的 银行卡 吗	支付宝 添加 别人 银行卡 的 问题	长 痔疮 有 什么 症状
麻烦 您 提供 一下 到 账 银行卡 后 四位 的 ， 小 二 帮 您 核实 一下 的	为了 准确 核对 信息 ， 麻烦 您 提供 下 金额 　 和 　 收款 银行卡 的 名称 　 给 我 下 哦 ！	怎么 可以 刷 空间 人气 ？
我 老公 总 爱 喝酒 怎么办	爱 喝酒 的 老公 我 该 怎么办	喜 羊 羊 大结局 是 什么 ？
黑米 手机 是 什么	蓝牙 耳机 充电器 是 什么 啊 ，	什么 方法 可以 去除 体内 的 湿气
血常规 能 检查 出 白血病 吗	血常规 能 检查 出 乙肝 吗	街头 篮球 很 卡
你 的 生活 幸福 吗	你 的 生活 过 的 幸福 吗 ？	怎么 修复 手机 内存卡 ？
女主角 多 的 小说	女主角 是 人 鱼 的 小说	好 的 ， 请问 需要 帮 您 一并 清空 安保 问题 的 吗 ？
小孩 不 吃饭 我 该 怎么办	我 要 疯 了 咋办 小孩 不 吃饭 怎么办	姐姐 结婚 ， 我 送 什么 礼物 好 啊
谁 有 天空 之 城 的 简谱 埙 的	谁 有 天空 之 城 的 简谱 啊	英雄 杀 如何 点亮 图标
请问 这位 女优 叫 什么 名字	请问 这位 女优 叫 什么 名字 ？	短发 拍 婚纱照 怎么 才 好看
日语 这 句 话 怎么 说 !	这 句 话 日语 怎么 说	这 是 什么 烟 啊 价格 多少 ？
洛克 王国 冰 龙王 是 什么 组 的	洛克 王国 的 冰 龙 宝宝 是 什么 组 的	女人 吃 什么 补血 呀 ？
热火 能 夺冠 不 ？	热火 能 夺冠 么	谁 知道 这个 包包 是 什么 牌子
过程 装备 与 控制工程 这个 专业 怎么样 ？	过程 装备 与 控制工程 专业 怎么样 ？	云南 好 ？ 还是 杭州 好 、
用 身份证 复印件 能 买 火车票 吗	只有 身份证 复印件 可以 取 火车票 吗	这 配置 玩游戏 怎么样 ？
梅 西 在 那个 球队 ！ ？	梅 西 是 那个 球队 的 ？	请问 是 忘记 了 安全 保护 问题 答案 是 吗 ？
什么 水果 好吃	什么 水果 是 最 好吃 的	米粉 怎么 做 好吃
男人 吃 自己 的 精液 好 吗	男人 可以 吃 自己 的 精子 吗	建议您 换 个 浏览器 试 下 ， 如果 还是 不行 的话 ， 建议您 电脑 端 操作 下 ， 辛苦 您 了
天空 的 星星 一 闪 一 闪 的 。	夜晚 ， 一 闪 一 闪 的 星星 - 撒满 天空	最近 有 什么 好看 的 电影 推荐
邮箱 手机 可以 用 吗 ？ 怎样 注册 邮箱 呢 ？	淘宝 注册 手机 注册 ？ 邮箱 注册 ？	手表 都 有 什么 什么 机芯
这个 玉镯 价格	这个 玉镯 的 价格	男人 可以 吃 自己 的 精子 吗
1977 年 农历 1 月 29 日 10 . 30 分 出生 的 缺什么	1977 年 农 厉 5 月 28 日 中午 1 点 30 分 出生 五行	现在 国家 副 主席 是 谁
请 推荐 几本 好书	推荐 几本 好书	杭州 科技 职业 技术 学院 和 浙江 旅游 职业 学院 哪个 好 ?
全民 枪战 怎么 刷 钻石	全民 枪战 怎么 得 钻石	这个 发型 怎么弄 ， 叫 什么 ？
美国 搞笑 的 电影 有 哪些	美国 一个 搞笑 电影 、	求 这 张 头像 的 情侣 图片
求 那些 花儿 朴树 原版 吉他谱	求 朴树 的 那些 花儿 原版 吉他谱	保护 青蛙 怎么样
怎样 删除 朋友圈 聊天记录	如何 彻底 删除 朋友圈	什么 是 街头 篮球 ？
如何 免费 下载 歌曲	怎么 下载 免费 歌曲	移动 高速 宽带 质量 如何 ？ 能 玩游戏 么 ？
几 什么 翠竹	什么 的 翠竹	很 抱歉 ， 如果 要 注销 主 账户 ， 是 需要 先 注销 子 账户 的 。
你 写 什么 类型 的	是 什么 类型	网上 订票 什么 时候 可以 取 票
有 谁 知道 这 是 什么 字体 。	有 谁 知道 这 是 什么 字体 ？	送 男生 什么 成人礼 礼物
全世界 什么 地方 的 女孩子 最 漂亮 ？	全世界 最 漂亮 最 贵 的 车 是 什么 车	星期六 的 英文 怎么 写
送 女朋友 生日礼物 送 什么 好 ？	送 女朋友 什么 生日礼物	谁 有 免费 的 黄页 ！
无 房 证明 怎么 开	无 房 证明 怎么 开 ？	亲 稍 等 我 帮 您 查询 下
求 吴 亦 凡 照片	求 吴 亦 凡 滴 照片 ！	家 纺 设计 国外 资料 网站
有没有 港台 国产 的 好看 的 恐怖片	最新 好看 的 国产 恐怖片	封神榜 下部 出 了 没
尴尬 什么 意思	尴尬 是 什么 意思 ？	找 一款 网页 游戏
胃药 是 饭前 吃 还是 饭后 吃	胃药 是 饭前 吃 还是 饭后 吃 ?	韩国 人 很 讨厌 日本 人 吗
成事不足 败事有余 用 英语 怎么 说	贱货 、 不要脸 的 英语 怎么 写	么 么 哒 ， 求 大神 解答
谁 有 好看 手机 壁纸	谁 有 好看 的 手机 壁纸	聚 来 宝 是 什么 ？ 真的 能 赚钱 吗 ？
他 说 得过且过 什么 意思	的 说 日语 什么 意思 哇 咔 咔 擦	谁 有 愤怒 小鸟 太空 版 破解版 的
北京 的 市花 是 什么 ？	北京 有 什么 市花	日 重 四 字 成语
绿 拼音 则 么 写	么 么 哒 之类 词语	良药苦口利于病 的 上 一句
谁 知道 我 图片 中 的 狗 是 什么 狗	谁 知道 图片 这个 女 的 叫 什么	中国 主席 是 几年 一届 的
中国 最早 的 黑帮 老大 是 谁 ？	中国 十大 黑帮 老大 是 谁 ？	安徽 职业 技术 学院 和 安徽 财贸 职业 学院 哪个 好 ?
北京 哪里 可以 骑马	北京 哪里 可以 学 骑马	北京 有 什么 市花
11 月 27 日 是 什么 星座	阳历 8 月 23 日 是 什么 星座	猜 你 妹 ， 这 是 什么 电影 ？
这种 发型 叫 什么 ？ 发 尾 往 里 弯 ？	这种 发型 叫 什么 ？	平安夜 要 送 什么 礼物 给 他 ！
中国 达 人 秀 第三季 南宁 在 哪里 报名 ？	中国 达 人 秀 第三季 上海 报名 地点 在 哪里 ？	火车 上 可以 带 菜刀 吗
微 信 朋友圈 怎么 删除 评论	微 信 朋友圈 怎么 一次性 删除	当 什么 兵 打架 厉害
在 精卫填海 中 ， 精卫 是 什么 ？	精卫填海 中 的 精卫 指 的 是 什么	图片 中 的 是 哪个 建筑 ， 在 哪里
骂人 的话 越 毒 越 好	骂人 的话 越 毒 越 好 骂 女 的	书店 里 买不到 的 是 什么 书
性生活 是 什么 感觉 的	性生活 是 什么 感觉 啊 ？	娱乐圈 的 潜规则 是 什么
你 的 孤独 虽败犹荣	孤独 虽败犹荣	玉米粒 怎么 做 好吃 ？
仙人掌 吃 了 有毒 吗	仙人掌 的 刺 有毒 吗 ？	什么 看 什么 视 三年级 语文 提
给 女朋友 取 一个 可爱 的 外号	想 给 自己 起 一个 好听 的 微 信 名	薏米 粥 可以 天天 喝 吗
股票 可以 网上 开户 吗 ？ 北京 的 。	北京 海淀区 有 股票 开户 的 地方 吗 ？	喝 绿茶 有 什么 好处 ？
涨停 股 怎样 买入	涨停 前 如何 买入	什么 牌子 的 空压机 好
失恋 了 ， 用 什么 个性 签名 好 。	有 什么 个性 签名 是 关于 姐妹 的 ？	手机 学 日语 的 软件
中国 品牌 都 有 哪些 ？	中国 自己 的 品牌 有 哪些	虹 之间 什么 意思 ？
寻 《 中国 文学史 》 袁行霈 的 TXT 格式 资源 ！	求 袁行霈 《 中国 文学史 》 名词解释 ！	关于 世界 三 大 禁 曲
云南 机电 职业 技术 学院 好不好 ?	云南 机电 职业 技术 学院 2016 有没有 自主 招生	开 网店 怎样 做 宣传
怎么样 让 牙齿 快速 美 白 ？	如何 快速 美 白 牙齿 ？	东莞 哪里 有 草莓 场 ？
胡萝卜 怎么 做 好吃 ？	胡萝卜 怎么 做 才 好吃	含 反义词 的 四 字 词语
微 信 公众 账号 都 有 什么 盈利模式 ？	微 信 公众 平台 盈利 有 哪些 模式 ？	我 的 世界 服务器 是 什么 ？
神马 都 是 浮云 > 是 什么 意思 ？	神马 都 是 浮云 什么 意思	哒 哒 哒 打打 打
这 衣服 配 什么 裤子 好看	这个 衣服 穿 什么 鞋 和 裤子 好看 呢	求 一本 网 王 同 人 ，
现在 做 什么 农业 项目 好 ？	在 农村 现在 做 什么 农业 好	逆 战 吧 测试 服 ？ 在 哪 玩 ？
什么 播放器 可以 缓存 海贼王	什么 手机 视频 播放器 可以 缓存 海贼王	国产 女士 香烟 都 有 什么 牌子 ？
我 的 世界 纸 怎么 合成	我 的 世界 画 怎么 合成	知趣 竞猜 这 是 什么 品牌 ！
现在 什么 3D 网游 好玩 ？ 类似 于 天龙八部 那种	有 什么 好玩 的 类似 天龙八部 的 网游	这 酒 多 钱 一瓶 ？
各个 季节 吃 什么 水果 好 ？	这个 季节 吃 什么 水果 好 ？	上海市委 书记 是
给予 是 快乐 的 什么 意思	给予 是 快乐 的 是 什么 意思 啊	香辣 鸡 怎么 做 ？
也 是 花 呗 支付 的 呢	亲 ， 是否 可以 使用 花 呗 以 付款 界面 为准	这 是 那 部 动漫 人物 ？
什么 品牌 手表 好	什么 品牌 的 手表 好	求 一款 赛车 游戏
求 武汉 得意 邀请 码	求 武汉 得意 网 邀请 码	为什么 登陆 不了 淘宝
求 闪 金 镇 一夜 和 红龙 女王	求 闪 金 镇 的 那 一夜 和 红龙 女王	找 一本 古 言 小说
做 我 男朋友 吧	做 我 男朋友 吧 ？	请问 这 女 的 叫 什么 名字
粉丝 什么 意思	甲 是 乙 的 粉丝 ， 是 什么 意思	如何 读 好 英语
如何 折 荷花	如何 画 荷花	马 云 是 谁 ?
求 一部 老 电视剧	急 找 一部 电视剧	如何 让 员工 服从 ？
我们 中国 的 国花 是 什么 ？	中国 的 国花 是 什么 啊 ？	中国 什么 时候 可以 收复 台湾
护士 的 职责 都 有 什么 ？	护士 的 职责 是 什么	英语 学习 网站 哪个 好
请问 这个 女主播 叫 什么 名字 ？	请问 下 图片 这个 女 的 叫 什么 名字 ？	微 信 密码 忘 了 怎么 找 回来
找 意境 唯美 的 女生 头像	求 女生 唯美 意境 头像	什么 动物 吃 老虎 呀 ？
无奈 ， 为什么 生活 总是 有 那么 多 的 不如意	为什么 我们 的 生活 有 太 多 的 无奈	为 你 变 乖 的 反义词 是 什么
守护 甜心 第四部 什么 时候 出 ？	守护 甜心 第四部 在 什么 出	建议您 卸载 支付宝 钱包 重新安装 试 下 的
打扰 别人 的 美梦 是 什么 成语	指 打扰 别人 的 美梦 是 什么 成语	常州 属于 哪个 省
过期 奶粉 能 喝 吗	奶粉 快 过期 了 还 能 喝 吗	辛苦 您 查询 一下 您 的 余额 宝 的 收支 明细 的
今年过年 流行 什么 衣服	今年过年 流行 什么 衣服 呢	你 新年 愿望 是 什么
向日葵 为什么 对 着 太阳 转	为什么 向日葵 向着 太阳 转	为什么 不能 支付宝 实名 认证 ？
您 是 在 12306 买 的 吗 ？	您好 . 请问 您 的 这个 是 163 . 126 还是 QQ 的 邮箱 .	皮肤 风衣 哪个 牌子 好 ?
英文字母 怎么 写 才 好看	谁 能 把 黄 字 写 好看 点	广袤 的 近义词 是 什么
小苹果 这 首歌 为什么 这么 火	小苹果 这 首歌 在 哪里 有 得 听 。	男生 咬 女生 代表 什么
赛尔 号 哈 莫 雷 特 。	赛尔 号 刷 米 币	怎么 能 快速 学会 一首歌 ？
我 喜欢 的 女生 不理 我 了 怎么办	喜欢 的 女生 不理 我 ， 怎么办	买 理财 有 风险 吗
我 为什么 喜欢 下雨天	求 一句 你们 喜欢 的 歌词 ？	独家 记忆 木 浮生
善待 的 善 什么 意思	善待 自己 的 意思 是 什么	佐酒 能量 块 哪里 能 买 到
怎么 调 电动车 的 限速 器 ？	三 挡 电动车 限速 器 怎么 调	手机 铃声 怎样 下载
农业银行 手机 银行 转账 多久 到 账	手机 银行 农业银行 转账 到 建行 要 多久	细雨 过 了 什么 雨
用 什么 软件 能 下载 游戏 的 视频 攻略	用 视频 可以 玩 的 游戏 从 哪里 下载 ？	什么 材质 的 衣服 又 薄 又 保暖 ？
西安 属于 哪个 省份	上海 哪个 区 租房子 最 便宜 ？ 急 } }	怎么 去 收缩 毛孔
什么 笑 大方 ( 成语 )	什么 大方 成语	淘宝 销量 怎样 提升
点钞机 哪个 牌子 好 ？	点钞机 哪个 牌子 好	您 在线 等待 一下 就 可以 的 ， 不要 关闭 对话框
微 信 怎么 绑定 新浪 微 博	微 信 如何 绑定 新浪 微 博	怎样 练出 翘 臀
这 什么 老鼠 ？	老鼠 爱 吃 什么	普通话 翻译成 粤语
有 什么 软件 可以 免费 读书	什么 软件 可以 在线 看书 免费 的	婴儿床 什么 牌子 好 ？ 求 荐 ？
用 什么 洗发水 比较 好 ？	天天 洗头 用 什么 洗发水 比较 好	请问 办 支付宝 怎么办 ？
主见 什么 意思 ？	主见 性 强 什么 意思 啊	两个 胖子 拥抱 ( 打 一 地名 )
相看 两 不厌 ， 只有 什么 什么 什么 ？	相看 两 不厌 ， 只有 ？ 什么	微 店 怎么 做 推广
猜 两字词 语	知趣 竞猜 猜 品牌	贴 吧 里 的 小尾巴 怎么 设置 ？
美国 入境 这些 东西 能带 吗 ？	美国 出入境 什么 东西 能 随身携带 ？	七龙珠 还有 剧场版 吗 ？
中国大学 机械 电子 工程 专业 排名	中国 高校 电子 信息工程 专业 势力 排名	女孩子 不 喜欢 什么 ？
为什么 有 的 支付宝 有 花 呗 有 的 没有	为什么 我 的 手机 支付宝 没有 蚂蚁 花 呗	部落 冲突 更新 没有 账号 怎么办
养 小鬼 是 真的 嘛	小鬼 是 真的 吗	我 妈妈 的 舅舅 和 我 的 关系 称谓 是 什么 ？
您好 ， 建议您 让 账户 的 本人 来访 的 ， 是 需要 核实 信息 等 的 。	是 需要 账户 本人 来访 核实 账户 信息 ， 建议您 联系 账户 本人 来访 核实 ， 麻烦 您 了 。	爸爸 去 哪儿 主题曲 下载
想 你 的 时候 听 着 情歌 流眼泪	求 听 你 听 我 张 杰 伴奏	排队 时间 在 1 分钟 足 有
现在 大学生 进入 大学 学 什么 专业 好 ?	现在 大学生 学 什么 专业 好找 工作	这 是 出自 哪个 动漫
我 的 世界 中文版 怎么 下载	我 的 世界 中文版 下载 ，	中国 的 国花 是 什么 啊 ？
死得其所 里 所 是 什么 意思 ？	死得其所 是 什么 意思 ？	大家 的 新年 愿望 是 什么
哪里 有 卖 工业 酒精 的 ？ 多少 钱 ？	工业 酒精 哪里 有 卖	中国 高校 电子 信息工程 专业 势力 排名
求 这 张 照片 的 原图 ！ 急 ！	求 这 张 照片 原图	蛇 和 哪个 属相 最 相配 ？
我 的 世界 邦 末 材质 包 。	我 的 世界 这个 是 什么 材质 包	什么 软件 可以 在线 看书 免费 的
这 是 什么 木头 啊	这 是 什么 木头 的	张 翰 和 郑 爽 为什么 分手
某 界 亚洲 互联网 大会 上马 云 的 对手 … 他 是 谁 ？	马 云 是 谁 ?	建议您 把 交易 记录 删除 一下 ， 重新 建立 交易 操作 的 ， 麻烦 了 。
怎么 在 阿里 妈妈 推广 呢	阿里 妈妈 怎么 推广 的 ？	一般 开 个 创意设计 工作室 要 多少 钱
本事 的 近义词 是 什么	本事 的 近义词	请问 ： 为什么 王八 是 乌龟
欲 钱 买 无精打采 的 动物 是 什么 生肖	欲 钱 买 短命 的 生肖 指 的 是 什么 ？	最近 有 什么 好 听的歌 吗
鸡蛋 炒 土豆 有毒 吗	鸡蛋 炒 土豆 有毒 吗 ？	求 一句 你们 喜欢 的 歌词 ？
全职 妈妈 做 什么 工作 好 ？	全职 妈妈 孩子 上 幼儿园 后 做 什么 工作 好	脚趾 发麻 怎么回事
什么 牌子 空调 最好	空调 啥 牌子 最好	南通市 是 在 哪个 省 ？
一身两役 说 的 是 什么 生肖	一身两役 是 什么 生肖	建议您 解 绑 您 的 这 张 银行卡 ， 再 进行 重新 绑定 。
夏天 吃 什么 水果 最好	酸奶 一般 什么 时候 喝 最好 ？	很 抱歉 ， 建议您 使用 本人 的 身份 信息 操作 注册 账户
给 老人 祝寿 送 什么 好	老人 祝寿 送 什么 好 ？	命 去掉 人 字头 念 什么
求 深圳 高 仿 休闲 运动鞋 货源	求 一条 阿迪达斯 三叶草 运动 休闲裤	什么 星座 的 人 最 不 受欢迎 ?
《 战火 ： 红色警戒 》	骆宾王 《 咏 鹅 》 ：	惊天动地 电影 观后感
如何 在 淘宝网 上 投诉 商家	在 淘宝网 上 怎么 投诉 商家 呢 ?	求 朴树 的 那些 花儿 原版 吉他谱
山东 青年 政治 学院 专科专业 分数线	山东 青年 政治 学院 专科	文章 和 马伊利 是 怎么 认识 的
海贼王 > 里 第几 集 是 打雷 神 的 ? 动漫	这个 是 海贼王 中 第几 集 ？	上班族 兼职 什么 好
有 在 网上 可以 赚钱 的 工作 吗 ？	在 网上 可以 做 什么 工作 ， 赚钱	苹果 手机 怎么 下载 游戏
创可贴 什么 牌子 好 呢 。	什么 牌子 的 创可贴 好	高铁 与 动车 的 区别 ？
为什么 说 小米 手机 是 垃圾 是 系统 还是 手机 质量	为什么 我 的 小米 手机 总是 在 后台 自动 下载 垃圾 软件	天天 洗头 用 什么 洗发水 比较 好
斗 罗 大陆 武魂 的 种类	斗 罗 大陆 武魂 殿 的 所有人	什么 品牌 的 裤子 好 穿
求 这 张 图 完整 图片	求 这 张 图 的 完整 图片 ！	今天天气 好 晴朗
脸上 的 痘 坑 怎么 去除 呀 ？	如何 去除 脸上 的 斑	爸爸 去 哪儿 2joe 和 贝 儿 谁 大
请问 这个 是 什么 品种 的 猫	请问 下 这个 狗 是 什么 品种 ？	您好 　 ２ ０ １ ３ 年 ２ . １ ７ － ２ . ２ ２ 日 　 没有 ３ １ ３ １ 　 的 交易 金额 。
赵 薇 的 女儿 叫 什么 名字	女孩 的 名字 叫 姚 什么 菲	怎么 把 视频 上 传到 土豆 网上
我 的 世界 怎么 用 海绵 吸水	我 的 世界 怎么 吸水 工具	骂人 的话 越 毒 越 好 骂 女 的
青岛 哪些 健身房 比较 好 ？	韩国 哪些 护肤品 好	魅 族 华为 小米 哪个 好
藏头诗 ！ 藏 周 诗 我 宣 你	求 藏头诗 ： 我 爱 吴 琼	安徽 特产 有 哪些 ？
笔 组词 ， 求学 霸	穗 组词 求学 霸	永恒 之 塔 怎么 回 这样
在 百度 怎么 上传 文件	如何 上传 文件 到 百度	母亲节 什么 时候 到
怎么 可以 查 到 开房 信息 ？	怎么 查 到 开房 信息	购买 中老年 服装
泡 芙 面膜 怎么 做 代理	怎样 招 面膜 代理 ？	人 肉 好吃 吗 ？ 谁 吃 过
什么 是 偶数 ， 什么 是 奇数 .	什么 叫 偶数 什么 叫 奇数	女生 打 耳洞 在 那 只 耳朵 吗 ？
不可一世 的 意思 是 什么 ？	不可一世 什么 意思	什么样 的 发票 可以 地税
立顿 红茶 是 什么 ？	立顿 红茶 是 什么 茶	男生 最 喜欢 女生 送 什么 礼物
学而不厌 下 一句	学而不厌 的 下 一句 子 。	天 语 手机 怎么 刷 机 啊
安徽 的 特产 有 哪些 ？	安徽 特产 有 哪些 ？	知趣 竞猜 猜 品牌
这个 是 什么 海鲜 ， 名字 叫 什么 ？	这 海鲜 叫 什么 名字 啊 ？	女性 汗毛 重 的 原因 是 什么
独家 记忆 木 浮生	独家 记忆 木 浮生	您好 ， 您 的 这个 红包 是 只能 在 这个 给 您 发送 红包 的 商家 使用 的 ， 麻烦 了 。
怎样 摸 乳房 ， 我 是 男 的	为什么 我 乳房 那么 小	尴尬 是 什么 意思 ？
求 泰坦 之 旅 不朽 王座 修改器	高分 求 泰坦 之 旅 装备 修改器	有 谁 知道 这 是 什么 字体 ？
图 怎么 画 简单 点 就 好	保暖 内衣 如何 保暖 ？	梅花香 自苦寒 来 的 上 一句 是 什么 ？
恋恋不舍 是 什么 意思 ？	恋恋不舍 的 舍 的 意思 是 什么	如何 查询 驾驶证 违章
石家庄 还有 什么 好玩 的 地方	石家庄 有 什么 好玩 的 地方	什么 脸型 这 是
心旷神怡 是 什么 意思	心旷神怡 的 意思 是 什么	英雄 联盟 电信 一 区 是 哪个 区 ？
于 虎 有关 的 名言	关于 路 的 名言	世界 上 什么 歌 最 难听 ？
怎样 给 别人 打电话 隐藏 自己 的 手机号码 ！	打电话 时 如何 隐藏 自己 的 手机号码	关于 一些 图片 的 问题
香蕉 泡 醋 吃 有 什么 作用	晚上 睡觉 前 喝 醋 有 什么 好处	您 买 的 是 什么 产品 的 呢
兔子 的 尾巴 一 歇后语	兔子 尾巴 的 歇后语	燕麦片 有 什么 用
如何 推广 好 我 的 微 店 ？	微 店 怎么 做 推广	( 搔头弄姿 ) 是 什么 生肖 ？
孩子 脸上 为什么 会 出现 小红点	为什么 脸上 会 突然 出现 一个个 的 小红点	怎样 可以 让 小腿 变 瘦
乌克兰 美女 多 吗	我 可以 娶 乌克兰 美女 吗 ？	查 星座 用 阳历 生日 还是 阴历 的
哪里 要 买 草莓 苗 ？	哪里 能 买 到 草莓 苗	您 可以 再 服务 窗 搜 花 呗 也 可以 的
杨 幂 和 刘恺威 他俩 怎么 认识 的 ？	杨 幂 与 刘恺威 怎么 认识 的 ，	有 什么 软件 可以 免费 看书 ？
小米 手机 好不好 ？	小米 手机 好不好	女人 吃 什么 豆 最好
红 米 手机 拍照 怎么样	红 米 手机 怎样 拍照	什么 烟 对 人 危害 最小
梦见 杀人 杀 不 死	梦见 我 自己 杀人	载 是 什么 结构 的 字
如何 写 好作文	怎么 写 好作文	这 是 哪个 牌子 的 香水
生存 战争 哪个 图 钻石 多	谁 有 愤怒 小鸟 太空 版 破解版 的	武汉 本地 急 找 工作
女朋友 不 开心 ， 我 怎么 哄 她 。	女朋友 不 高兴 了 怎么 哄 她 开心 。	请问 这个 表情 叫 什么 ？
时空 猎人 的 冰魄 要 什么 才能 觉醒	时空 猎人 里 的 龙 灵 怎么 觉醒 ？	夜宵 吃 什么 内 ？
这个 字 代表 什么 意思 ？	左 腮 跳 是 代表 什么 意思	不 客气 的 ， 保持 手机 畅通 ， 等待 电话 联系 您
老虎 的 耳朵 有 什么 用	老虎 的 左 耳朵 像 什么 ？	苹果 手机 怎么 截图 ？
求 大神 解答 啊	么 么 哒 ， 求 大神 解答	我国 的 四大发明 是 什 麽
奥拉 星 那位 大神 帮 我 打 圣光 修罗 ？	谁 带 我 打 奥拉 星 圣光 修罗 伙伴 试练	黑色 男士 运动 休闲鞋 配 什么 裤子 好看 ？
找 一个 卡通 情侣 头像 急	求 一个 卡通 情侣 头像	同桌 的 你 电影 完整版 ！
推荐 好 的 书籍	推荐 好 电影	求 个 能 看 或 下载 日文 轻 小说 的 地方
麻烦 您 了 ， 给 您 带来 的 不便 ， 希望 没有 影响 到 您 的 心情 ， 希望 您 可以 早点 休息	嗯 ， 麻烦 您 了 ， 给 您 带来 的 不便 ， 希望 没有 影响 到 您 的 心情	气吞山河 是 什么 生肖
这位 模特 叫 什么 名字 ？	这位 模特 叫 什么 名字	怎样 去除 脸上 的 雀斑 ？
正常 将 显示 的 】	这边 的 状态 显示 是 等待 确认 的	求 一部 国产电影
初三 数学题	【 理财 知识 】	哪部 韩剧 吻 戏 最 多
建议您 先 操作 充值 到 支付宝 账户 余额 ， 充值 之后 再 进行 付款 的	把 钱 先 用 充值 的 方式 充值 到 支付宝 账户 余额 然后 您 再 操作 进行 付款	我 的 世界 你 这个 哪里 下载 ？
异地 而 居 的 异 是 什么 意思	异地 恋 什么 意思	上海 哪里 洗 纹身 好
谁 知道 这 是 什么 东西 …	这 是 什么 东西 ， 我 的确 不 知道	大家 买 书 一般 上 哪个 网站 买 ？
华为 魅 族 小米 哪个 好	魅 族 华为 小米 哪个 好	约瑟 传说 翼 灵兽 怎么 打
女士 手表 哪些 品牌	女士 手表 品牌 有 哪些	哺乳期 能 烫发 吗
女性 体毛 过 多 是 什么 原因	女性 汗毛 重 的 原因 是 什么	女主角 是 人 鱼 的 小说
恩 呢 ， 这边 有 查看 到 您 说 的 这个 记录 的 噢	维权 退款 的 您 可以 咨询 下 淘宝 那边 看 下 那边 退款 目前 是 什么 情况	现在 的 老师 怎么 都 这样 ？
谁 给 个 御 龙 在 天 激活码 ？ 追 分	逆 战 吧 测试 服 ？ 在 哪 玩 ？	描写 人 神态 的 成语
什么 酒 的 酒 心 巧克力 好吃	什么 酒 心 巧克力 好吃	求 か な で 雪 音 表情 包 全套 嗷 。
弹弹 堂 敏捷 有 什么 用	弹弹 堂 敏捷 有 什么 用 …	贵族 完结 天籁 纸鸢
求 北科大 冶金 工程 本科 历年 期末考试 试题	求 冶金 工程 设备 采购 的 资料	什么 的 小河 ？
大便 时 ， 出血 ， 是 什么 原因 ？	仙人掌 开花 了 ， 是 好 还是 坏 ？	性与爱 有 什么 区别
什么 是 负 二代	牙 啫喱 是 什么	我家 兔子 怀孕 后 摸不到 胎儿
像 《 蜀山 传 》 这样 的 电影 还有 那些	求 类似 《 恐怖 游轮 》 的 电影 ！	买 二手车 都 需要 注意 什么
有 什么 美 剧 好看 吗	什么 美 剧 好看 。	如何 免费 下载 中国 知 网 论文
乔布斯 是 怎样 死 的 ？	乔布斯 是 怎么 死 的 ？	宝宝 拉肚子 可以 打预防针 吗 ？
如何 查询 银行卡 的 余额	查询 银行卡 余额 怎么 查 ？	这 海鲜 叫 什么 名字 啊 ？
篡 去掉 竹 字头 念 什么	命 去掉 人 字头 念 什么	怎样 把 照片 做成 视频
吃 什么 东西 可以 排毒	吃 什么 东西 可以 排毒 ？	怎样 快速 赚钱 啊 ？
娱乐圈 潜规则 是 什么	娱乐圈 的 潜规则 是 什么	名 侦探 柯 南 什么 时候 能 有 大结局 ？
八年级 上 物理 练习册 答案	八年级 上 物理 沪 粤 版 练习册 答案	支付宝 里 手机 支付 密码 是 什么
支付宝 怎么 绑定 淘宝 号 ？	支付宝 怎么样 才能 和 淘宝 绑定	都 有 哪些 外国 诗人 写 的 诗 好 啊
国 通 快递 怎么样 ？	国 通 快递 怎么样	孕妇 能 吃 奇异果 吗 ？
直销 与 传销 的 区别 ？	直销 和 传销 的 区别 ？	我爱你 的 韩文 怎么 写
如何 玩 呼啦圈 ？	呼啦圈 怎么 转 ？	花瓶 是 什么 意思 ？
天牛 吃 什么	天牛 吃 什么 啊 在 哪 找 啊	苹果 手机 万能钥匙 怎么 用
开封 的 香烟 能 存放 多久	一盒 香烟 不 拆开 能 存放 多久 ？	膜法 传奇 面膜 怎么样
