海尔 全 自动 洗衣机 怎么 样 海尔 全 自动 洗衣机 怎么样	海尔 全 自动 洗衣机 怎么 用 海尔 全 自动 洗衣机 怎么 用
在家 电脑 做 什么 兼职 好 呢 在家 电脑 做什么 兼职 好 呢	两 台 电脑 做 什么 兼职 好 呢 两 台 电脑 做 什么 兼职 好 呢
这 是 什么 动漫 的 图片 啊 } 这 是 什么 动漫 的 图片 啊 }	这 是 动漫 还是 图片 这 是 动漫 还是 图片
一尘不染 的 染 是 什么 意思 一尘不染 的 染 是 什么 意思	一尘不染 中 的 染 什么 意思 一尘不染 中 的 染 什么 意思
我 的 狐仙 女友 第二 季 什么 时候 出来 我的狐仙女友 第二季 什么 时候 出来	我 的 狐仙 女友 什么 时候 出 第二 季 ？ 我的狐仙女友 什么 时候 出 第二季 ？
什么 方法 解酒 最 快 ， 什么 方法 解酒 最 快 ，	什么 方法 解酒 最 快 什么 方法 解酒 最 快
上 火车 能带 酒 和 食用 油 吗 上 火车 能带 酒 和 食用油 吗	火车 上 能带 食用 油 吗 火车 上 能带 食用油 吗
可以 用 别人 的 银行 卡 去 开通 支付宝 吗 可以 用 别人 的 银行卡 去 开通 支付宝 吗	支付宝 转入 可以 用 别人 名字 的 银行 卡 吗 支付宝 转入 可以 用 别人 名字 的 银行卡 吗
吃 酸 的 水果 对 人 有 什么 好处 ？ 吃 酸 的 水果 对 人 有 什么 好处 ？	水果 对 人 有 什么 好处 ？ 水果 对 人 有 什么 好处 ？
什么 娱乐 节目 最 好看 什么 娱乐节目 最 好看	有 什么 好看 的 娱乐 节目 有 什么 好看 的 娱乐节目
淘宝 帐号 升 钻 怎么 淘宝 帐号 升 钻 怎么	淘宝 帐号 怎么 开 淘宝 帐号 怎么 开
图片 上 得 牌子 是 什么 图片 上 得 牌子 是 什么	图片 上 是 什么 牌子 的 包 图片 上 是 什么 牌子 的 包
瞻仰 这个 词 的 意思 是 什么 ？ 瞻仰 这个词 的 意思 是 什么 ？	瞻仰 的 仰 是 什么 意思 ？ ！ 瞻仰 的 仰 是 什么 意思 ？ ！
孕妇 可以 吃 干 豆角 吗 孕妇 可以 吃 干 豆角 吗	孕妇 可以 吃 泡 豆角 吗 孕妇 可以 吃 泡 豆角 吗
什么 电影 播放 器 最 全 什么 电影 播放器 最全	什么 手机 app 电影 播放 器 的 免费 最 多 什么 手机 app 电影 播放器 的 免费 最多
什么 都 没有 穿 的 美女 什么 都 没有 穿 的 美女	美女 什么 都 没有 穿 美女 什么 都 没有 穿
怎么 删除 开房 记录 ， 查询 怎么 删除 开房 记录 ， 查询	怎么 查询 开房 记录 ？ 删除 怎么 查询 开房 记录 ？ 删除
流动 人口 婚育 证明 如何 办理 流动人口 婚育证明 如何 办理	如何 办理 流动 人口 婚育 证明 如何 办理 流动人口 婚育证明
人类 的 终极 目标 是 什么 啊 人类 的 终极目标 是 什么 啊	人类 终极 目标 是 什么 ？ 人类 终极目标 是 什么 ？
求 好看 的 非 主流 女生 头像 。 求 好看 的 非主流 女生 头像 。	找 好看 的 非 主流 女生 头像 找 好看 的 非主流 女生 头像
百度 网盘 怎么 加 好友 百度 网盘 怎么 加 好友	百度 网盘 如何 加 好友 百度 网盘 如何 加 好友
淘宝 元旦 一般 打折 吗 淘宝 元旦 一般 打折 吗	元旦 淘宝 打折 么 ？ 打 几 折 元旦 淘宝 打折 么 ？ 打 几折
手机 银行 怎么 开通 手机 银行 怎么 开通	怎么 开通 手机 银行 怎么 开通 手机 银行
哗 ( 第一 声 ) 怎么 组词 哗 ( 第一声 ) 怎么 组词	正 ( 第一 声 ) 怎么 组词 正 ( 第一声 ) 怎么 组词
如何 恢复 已 删除 的 文件 如何 恢复 已 删除 的 文件	如何 将 删除 的 文件 恢复 如何 将 删除 的 文件 恢复
松 す み れ 中文 名字 是 什么 松 す み れ 中文 名字 是 什么	中文 叫 什么 名字 中文 叫 什么 名字
登陆 小米 账号 登陆 小米 账号	小米 账号 在 哪 登陆 小米 账号 在 哪 登陆
烫发 怎么 打理 烫发 怎么 打理	烫发 后 如何 打理 ？ 烫发 后 如何 打理 ？
怎么样 才能 戒烟 怎么样 才能 戒烟	怎么样 才能 戒烟 ？ 怎么样 才能 戒烟 ？
女孩 好听 的 网名 女孩 好听 的 网名	好听 的 ， 女孩 网名 。 好听 的 ， 女孩 网名 。
作文 《 妈妈 ， 让 我 说 声 谢谢 你 》 作文 《 妈妈 ， 让 我 说 声 谢谢你 》	谢谢 你 ， 妈妈 作文 谢谢你 ， 妈妈 作文
怀孕 了 可以 做 面膜 吗 怀孕 了 可以 做 面膜 吗	怀孕 可以 用 面膜 吗 ？ 怀孕 可以 用 面膜 吗 ？
梦见 有人 拿 刀 刺 向 我 。 梦见 有人 拿 刀 刺 向 我 。	梦见 有人 拿 刀 杀 我 梦见 有人 拿 刀 杀 我
为 字 在 第三 个 的 成语 有 哪些 ? 为 字 在 第三个 的 成语 有 哪些 ?	第三 个 字 是 之 的 成语 有 哪些 第三个 字 是 之 的 成语 有 哪些
有 什么 好 的 看 电影 软件 ？ 有 什么 好 的 看电影 软件 ？	有 什么 可以 看 电影 的 软件 。 有 什么 可以 看电影 的 软件 。
上面 一个 鹿 底下 一 个 章 。 上面 一个 鹿 底下 一 个 章 。	上面 一个 厶 底下 一 个 儿 上面 一个 厶 底下 一 个 儿
淘宝 开店 需要 什么 软件 ？ 淘宝 开店 需要 什么 软件 ？	淘宝 开店 需要 什么 软件 淘宝 开店 需要 什么 软件
怎样 投诉 淘宝 店铺 怎样 投诉 淘宝 店铺	淘宝 怎么 投诉 店铺 淘宝 怎么 投诉 店铺
聚精会神 的 神 是 什么 意思 聚精会神 的 神 是 什么 意思	聚精会神 中 的 会 是 什么 意思 聚精会神 中 的 会 是 什么 意思
我 喜欢 捆绑 美女 的 视频 ， 怎么 办 ？ 我 喜欢 捆绑 美女 的 视频 ， 怎么办 ？	我 想 要 一些 捆绑 美女 的 视频 和 图片 ， 有 追加 我想要 一些 捆绑 美女 的 视频 和 图片 ， 有 追加
怎么 投诉 天猫 卖家 怎么 投诉 天猫 卖家	如何 投诉 天猫 卖家 如何 投诉 天猫 卖家
汽车 公里 表 怎么 看 呢 汽车 公里 表 怎么看 呢	汽车 公里 表 怎么 调 汽车 公里 表 怎么 调
这个 老 玛瑙 珠子 值 多少 钱 这个 老 玛瑙 珠子 值 多少 钱	这个 玛瑙 珠子 怎么 样 ？ 这个 玛瑙 珠子 怎么样 ？
什么 铜钱 最 值钱 ？ 什么 铜钱 最值钱 ？	什么 铜钱 最 值钱 什么 铜钱 最值钱
八 个 月 宝宝 可以 吃肉 吗 八个月 宝宝 可以 吃肉 吗	八 个 月 宝宝 能 吃 油 吗 八个月 宝宝 能 吃 油 吗
求 个 那个 网站 求 个 那个 网站	求 个 好 网站 。 求 个 好 网站 。
狼吞虎咽 的 近义词 是 什么 狼吞虎咽 的 近义词 是 什么	狼吞虎咽 近义词 县 什么 ？ 狼吞虎咽 近义词 县 什么 ？
盗号 软件 有 什么 ？ 在 哪里 买 盗号 软件 有 什么 ？ 在 哪里买	什么 软件 可以 盗号 ？ 什么 软件 可以 盗号 ？
有 什么 动画 片 好看 的 有 什么 动画片 好看 的	什么 动画 片 好看 什么 动画片 好看
求 豆花 文 《 刺莲 》 的 完整 版 求 豆花文 《 刺莲 》 的 完整版	求 豆花 文 《 床 伴 》 完整 版 ！ 求 豆花文 《 床 伴 》 完整版 ！
怎样 用 口香糖 粘 鞋子 怎样 用 口香糖 粘 鞋子	鞋子 上 沾 了 口香糖 ， 怎么 搞 鞋子 上 沾 了 口香糖 ， 怎么 搞
就 这 配置 能 玩 幻想 神 域 吗 就 这 配置 能 玩 幻想神域 吗	这个 配置 可以 玩 幻想 神 域 吗 。 这个 配置 可以 玩 幻想神域 吗 。
怎么 健康 瘦脸 怎么 健康 瘦脸	怎么 样 瘦脸 最 健康 ？ 怎么样 瘦脸 最 健康 ？
创业 计划 书 怎么 写 创业计划书 怎么写	创业 计划 书 怎么 写 ？ 创业计划书 怎么写 ？
用 分数 混合 运算 用 分数混合运算	分数 混合 运算 三 分数混合运算 三
现在 什么 科幻 电影 好看 现在 什么 科幻电影 好看	现在 有 什么 好看 的 科幻 电影 啊 现在 有 什么 好看 的 科幻电影 啊
四脚朝天 是 指 什么 生肖 四脚朝天 是 指 什么 生肖	板凳 倒立 四脚朝天 是 什么 生肖 板凳 倒立 四脚朝天 是 什么 生肖
求 女 朋友 原谅 求 女朋友 原谅	如何 求 的 女 朋友 原谅 如何 求 的 女朋友 原谅
男人 为什么 喜欢 菊花 ？ 男人 为什么 喜欢 菊花 ？	为什么 男人 喜欢 被 人 玩 菊花 为什么 男人 喜欢 被 人 玩 菊花
芹菜 包 什么 肉 好吃 芹菜 包 什么 肉 好吃	芹菜 炒 啥 好吃 芹菜 炒 啥 好吃
求 这个 动漫 人物 出处 ！ 求 这个 动漫 人物 出处 ！	这个 动漫 人物 ， 求 出处 ~ 这个 动漫 人物 ， 求 出处 ~
天理难容 是 什么 生肖 ？ 天理难容 是 什么 生肖 ？	天理难容 是 什么 生肖 天理难容 是 什么 生肖
大家 都 笑 你 打 一 中国 城市 名 ) 大家 都 笑 你 打 一 中国 城市 名 )	猜 一 打 中国 城市 猜一猜 打 中国 城市
这 张 图 是 哪儿 这 张 图 是 哪儿	这 张 图 谁 有 这 张 图 谁 有
我 这 是 什么 脸型 剪 发型 好看 我 这 是 什么 脸型 剪 发型 好看	内 脸型 留 什么 发型 好看 内 脸型 留 什么 发型 好看
最近 过 的 怎么 样 ？ 最近 过 的 怎么样 ？	你们 最近 过 的 怎么 样 ？ 你们 最近 过 的 怎么样 ？
《 缇 索 救父 》 文言 文 《 缇 索 救父 》 文言文	文言 文 《 陈 元 方 》 文言文 《 陈 元 方 》
怎么 把 余额 宝 的 钱 转到 支付宝 怎么 把 余额宝 的 钱 转到 支付宝	怎么 把 手机 支付宝 余额 转到 宝 怎么 把 手机 支付宝 余额 转到 余额宝
在 网上 怎么 付钱 买 衣服 在 网上 怎么 付钱 买 衣服	在 怎么 才 能 网上 买 衣服 在 怎么 才能 网上 买 衣服
聪明 的 近义词 是 什么 聪明 的 近义词 是 什么	聪明 的 近义词 是 什么 呢 聪明 的 近义词 是 什么 呢
怎么 查 手机 短信 内容 ? 怎么 查 手机 短信内容 ?	怎么 查 别人 的 手机 短信 内容 ？ 怎么 查 别人 的 手机 短信内容 ？
拔罐 减肥 有效 吗 ？ 有 在 拔 的 拔罐 减肥 有效 吗 ？ 有 在 拔 的	拔罐 减肥 有效 吗 拔罐 减肥 有效 吗
房产 中介 怎么 做 ？ 房产中介 怎么 做 ？	如何 做 房产 中介 ？ 如何 做 房产中介 ？
春节 旅游 往 哪里 走 ？ 春节 旅游 往 哪里 走 ？	春节 去 哪里 旅游 好 ？ 春节 去哪里 旅游 好 ？
哪里 下载 免费 电子 书 哪里 下载 免费 电子书	在 哪里 能 下载 免费 的 电子 书 在 哪里 能 下载 免费 的 电子书
我 是 歌手 3 昨晚 排名 ？ 我 是 歌手 3 昨晚 排名 ？	昨晚 的 我 是 给 歌手 排名 昨晚 的 我 是 给 歌手 排名
动画 片 里 的 帅 男 图片 动画片 里 的 帅 男 图片	这个 图片 是 哪个 动画 片 这个 图片 是 哪个 动画片
得 了 糖尿病 会 怎么 样 呢 得 了 糖尿病 会 怎么样 呢	糖尿病 怎么 治 糖尿病 怎么 治
宽带 和 光纤 有 什么 区别 宽带 和 光纤 有 什么 区别	光纤 和 宽带 有 什么 区别 ？ 光纤 和 宽带 有 什么 区别 ？
这 阿迪达斯 是 正品 吗 ？ 如图 这 阿迪达斯 是 正品 吗 ？ 如图	这 阿迪达斯 是 正品 吗 ？ 这 阿迪达斯 是 正品 吗 ？
炭 木耳 是 什么 意思 炭 木耳 是 什么 意思	黒 木耳 是 什么 意思 黒 木耳 是 什么 意思
地瓜 怎么 煮 才 好吃 ！ 地瓜 怎么 煮 才 好吃 ！	地瓜 叶 怎么 炒 才 好吃 啊 地瓜 叶 怎么 炒 才 好吃 啊
在 百度 上 ， 图片 怎么 下载 ？ 在 百度 上 ， 图片 怎么 下载 ？	怎么 下载 百度 的 图片 怎么 下载 百度 的 图片
静 什么 的 心情 静 什么 的 心情	心情 什么 静 心情 什么 静
哪里 批发 服装 便宜 哪里 批发 服装 便宜	哪里 有 便宜 服装 批发 哪里 有 便宜 服装 批发
上 哨 带 手机 检讨 书 上 哨 带 手机 检讨书	手机 被 收 检讨 书 手机 被 收 检讨书
属 鸡 的 是 啥 星座 属鸡 的 是 啥 星座	属 鸡 的 。 是 什么 星座 属鸡 的 。 是 什么 星座
淘 模板 是 什么 ？ 淘 模板 是 什么 ？	什么 是 大 模板 什么 是 大 模板
我 爱 上 了 嫂子 我 爱上 了 嫂子	我 和 嫂子 我 和 嫂子
怎么 搞 、 才 能 让 女人 满足 怎么 搞 、 才能 让 女人 满足	怎么样 才 能 让 女人 满足 ？ 怎么样 才能 让 女人 满足 ？
我 的 世界 怎么 给 木板 上 颜色 我的世界 怎么 给 木板 上 颜色	我 的 世界 如何 分解 木板 我的世界 如何 分解 木板
咋 都 没 人 说话 呢 ！ 咋 都 没 人 说话 呢 ！	怎么 没 人 说话 怎么 没 人 说话
可爱 的 近义词 是 什么 啊 可爱 的 近义词 是 什么 啊	可爱 的 近义词 是 什么 可爱 的 近义词 是 什么
我 的 配置 能 玩 幻想 神 域 么 我 的 配置 能 玩 幻想神域 么	我 的 配置 可以 玩 幻想 神 域 吗 我 的 配置 可以 玩 幻想神域 吗
这 两双 鞋 哪 款 好看 呢 ？ 这 两双鞋 哪款 好看 呢 ？	帮 我 看看 这 两双 鞋 哪 款 好好 帮我看看 这 两双鞋 哪款 好好
产妇 喝 什么 下奶 好 啊 产妇 喝 什么 下奶 好 啊	产妇 喝 什么 下奶 产妇 喝 什么 下奶
梦见 捡 鸡蛋 什么 意思 梦见 捡 鸡蛋 什么 意思	梦见 拾 鸡蛋 是 什么 意思 梦见 拾 鸡蛋 是 什么 意思
小 眼睛 有 什么 成语 形容 小眼睛 有 什么 成语 形容	形容 眼睛 一 眨 不 的 成语 是 什么 形容 眼睛 一 眨 不 的 成语 是 什么
空间 的 背景 音乐 是 什么 空间 的 背景音乐 是 什么	qq 空间 背景 音乐 是 什么 格式 的 qq空间 背景音乐 是 什么 格式 的
吃 什么 东西 可以 壮阳 吃 什么 东西 可以 壮阳	什么 东西 最 壮阳 什么 东西 最 壮阳
关于 在 深圳 找 兼职 关于 在 深圳 找兼职	在 深圳 ， 想 找 兼职 在 深圳 ， 想 找 兼职
女 孩子 不 喜欢 什么 ？ 女孩子 不喜欢 什么 ？	女 孩子 喜欢 吃 什么 菜 女孩子 喜欢 吃 什么 菜
韩国 那些 女 明星 上 哪里 整容 呀 韩国 那些 女明星 上 哪里 整容 呀	韩国 女 明星 一般 去 哪里 整容 ？ 韩国 女明星 一般 去哪里 整容 ？
临时 身份证 能 上网 吗 ？ 临时 身份证 能 上网 吗 ？	临时 身份证 可以 上网 吗 ？ 临时 身份证 可以 上网 吗 ？
蟑螂 吃 人 吗 … 蟑螂 吃 人 吗 …	小 蟑螂 会 咬人 吗 ？ 小蟑螂 会 咬人 吗 ？
九 美 子 的 化妆 品 怎么 样 ？ 九美子 的 化妆品 怎么样 ？	九美子 化妆 品 怎么 样 ？ 九美子 化妆品 怎么样 ？
在 网 上 如何 买 东西 在 网上 如何 买东西	在 网上 怎么 买 东西 呢 ？ 在 网上 怎么 买东西 呢 ？
墨迹 是 什么 意思 ？ 墨迹 是 什么 意思 ？	你 真 墨迹 是 什么 意思 你 真 墨迹 是 什么 意思
帮忙 看 下 这个 是 什么 字体 帮忙 看 下 这个 是 什么 字体	帮忙 看 下 这 是 什么 字体 ？ 帮忙 看 下 这 是 什么 字体 ？
正月 十五 是 什么 节 正月十五 是 什么 节	正月 十五 吃 什么 正月十五 吃什么
怎么 取消 手机 里 的 黑 名单 啊 怎么 取消 手机 里 的 黑名单 啊	怎么 取消 手机 黑 名单 ？ 怎么 取消 手机 黑名单 ？
有 什么 好玩 的 策略 游戏 吗 ？ 有 什么 好玩 的 策略 游戏 吗 ？	什么 策略 游戏 最 好玩 什么 策略游戏 最 好玩
今年 快递 什么 时候 放假 啊 今年 快递 什么 时候 放假 啊	今年 的 快递 什么 时候 放假 今年 的 快递 什么 时候 放假
谁 有 约会 大 作战 剧场 版 资源 谁 有 约会 大作战 剧场版 资源	谁 有 约会 大 作战 的 剧场 版 资源 谁 有 约会 大作战 的 剧场版 资源
右 耳朵 烫 代表 什么 右 耳朵 烫 代表 什么	耳朵 厚 代表 什么 ？ 耳朵 厚 代表 什么 ？
一字千金 什么 意思 一字千金 什么 意思	一字千金 是 什么 意思 一字千金 是 什么 意思
现在 吃 什么 最 好 啊 现在 吃 什么 最好 啊	现在 最 好 的 爆吧 器 是 什么 现在 最好 的 爆吧 器 是 什么
艾 尔 之 光 澄 说 的 是 什么 话 艾尔之光 澄 说 的 是 什么 话	艾 尔 之 光 澄 什么 时候 出 ？ 艾尔之光 澄 什么 时候 出 ？
一番 作为 是 什么 意思 一番 作为 是 什么 意思	撸 一番 是 什么 意思 撸一番 是 什么 意思
微 分子 的 性质 是 什么 微 分子 的 性质 是 什么	分子 的 性质 是 什么 ？ 分子 的 性质 是 什么 ？
手机 看 电影 哪个 网站 更新 速度 最 快 手机 看电影 哪个 网站 更新 速度 最 快	哪个 网站 的 电影 更新 最 快 哪个 网站 的 电影 更新 最 快
梦见 拔 花生 是 什么 意思 梦见 拔 花生 是 什么 意思	梦见 种 花生 什么 意思 梦见 种 花生 什么 意思
逆战 飓风 之 龙 逆战 飓风 之 龙	逆战 送 飓风 之 龙 的 号 逆战 送 飓风 之 龙 的 号
移动 宽带 怎么 样 ？ 移动 宽带 怎么样 ？	移动 宽带 怎么 样 移动 宽带 怎么样
求 《 宝贝 真 乖 》 全文 ， 谢 ！ 求 《 宝贝 真 乖 》 全文 ， 谢 ！	求 宝贝 真 乖 全文 求 宝贝 真 乖 全文
圆周率 是 谁 发明 的 ? 圆周率 是 谁 发明 的 ?	是 谁 发明 了 圆周率 是 谁 发明 了 圆周率
爱情 和 婚姻 的 区别 是 什么 ？ 爱情 和 婚姻 的 区别 是 什么 ？	爱情 与 婚姻 有 什么 区别 么 ？ 爱情 与 婚姻 有 什么 区别 么 ？
作文 《 我 爱 什么 》 作文 《 我 爱 什么 》	因为 有 什么 ， 我 更 的 作文 因为 有 什么 ， 我 更 的 作文
你 为什么 喜欢 周杰伦 译文 你为什么 喜欢 周杰伦 译文	周杰伦 中 有 我 喜欢 你 这 句 歌词 是 什么 歌 周杰伦 中 有 我 喜欢 你 这 句 歌词 是 什么 歌
上火 会 牙痛 吗 上火 会 牙痛 吗	牙痛 是 上火 吗 牙痛 是 上火 吗
今天 深圳 天气 怎么 样 ？ 今天 深圳 天气 怎么样 ？	今天 深圳 天气 如何 今天 深圳 天气 如何
谢文东 第三 季 在 什么 播放 器 里 看 谢文东 第三季 在 什么 播放器 里 看	谢文东 第三 季 要 在 什么 播放 器 里 看 谢文东 第三季 要 在 什么 播放器 里 看
小学生 适合 看 什么 书 请 推荐 小学生 适合 看 什么 书 请 推荐	有 什么 适合 小学生 六 年级 学生 看 的 书 有 什么 适合 小学生 六年级 学生 看 的 书
南宁 属于 哪个 省 南宁 属于 哪个 省	南宁 是 属于 哪个 省 南宁 是 属于 哪个 省
芈月 传 什么 时候 上映 芈月传 什么 时候 上映	《 打狗 棍 》 什么 时候 上映 《 打狗棍 》 什么 时候 上映
这 是 什么 动物 这 是 什么 动物	这 是 什么 动物 的 角 这 是 什么 动物 的 角
杭州 的 特产 是 什么 杭州 的 特产 是 什么	杭州 有 什么 特产 杭州 有 什么 特产
如何 开发 微信 公众 平台 如何 开发 微信 公众 平台	一个 旅游 开发 公司 如何 维护 微信 公众 平台 一个 旅游 开发 公司 如何 维护 微信 公众 平台
卫浴 哪个 品牌 好 卫浴 哪个 品牌 好	卫浴 有 哪些 品牌 卫浴 有 哪些 品牌
牡丹 花 是 什么 样 的 图片 牡丹花 是 什么 样 的 图片	牡丹 花 的 图片 牡丹花 的 图片
怎么 看 是 肾 阴虚 还 阳虚 怎么看 是 肾阴虚 还是 肾阳虚	我 是 肾 阴虚 ， 还是 阳虚 我 是 肾阴虚 ， 还是 肾阳虚
求 另 一个 情侣 头像 谢谢 ！ 求 另一个 情侣 头像 谢谢 ！	找 一个 和 这 一样 的 情侣 头像 谢谢 找一个 和 这 一样 的 情侣 头像 谢谢
求 此 图片 出处 ！ 求 此 图片 出处 ！	求 此 图片 出处 … 求 此 图片 出处 …
白头 粉刺 怎么 去除 ？ 白头粉刺 怎么 去除 ？	白头 粉刺 怎么 去除 白头粉刺 怎么 去除
狼 爱 上 羊 是 指 什么 生肖 狼爱上羊 是 指 什么 生肖	狼 爱 上 羊 指 的 是 什么 生肖 狼爱上羊 指 的 是 什么 生肖
安装 系统 出现 的 问题 ！ 安装 系统 出现 的 问题 ！	安装 系统 出现 问题 ！ 安装 系统 出现 问题 ！
姓名 查 身份证 号码 怎么 姓名 查 身份证号码 怎么	只有 姓名 怎么 查 身份证 号码 ？ 只有 姓名 怎么 查 身份证号码 ？
厦门 去 哪里 钓鱼 厦门 去哪里 钓鱼	厦门 哪里 可以 钓鱼 厦门 哪里 可以 钓鱼
怎么 用 手机 下载 视频 怎么 用手机 下载 视频	怎么 下载 视频 到 手机 里 ？ 怎么 下载 视频 到 手机 里 ？
藜麦 是 酸性 还 碱性 的 藜麦 是 酸性 还是 碱性 的	醋 是 酸性 的 还 碱性 ？ 醋 是 酸性 的 还是 碱性 ？
怎样 保养 自己 的 头发 ？ 怎样 保养 自己 的 头发 ？	怎么 样 保养 好 自己 的 头发 怎么样 保养 好 自己 的 头发
有 没 人 知道 这 是 什么 狗 ？ 有没有 人 知道 这 是 什么 狗 ？	有 没 人 知道 这 是 什么 书 ？ 有没有 人 知道 这 是 什么 书 ？
好看 的 种马 小说 好看 的 种马 小说	好看 种马 小说 好看 种马 小说
百度 知道 怎么 修改 用户 名 百度 知道 怎么 修改 用户名	百度 知道 的 用户 名 怎么 修改 百度 知道 的 用户名 怎么 修改
＂ 高 大爷 是 什么 意思 ＂ 高 大爷 是 什么 意思	你 大爷 什么 意思 ？ 你 大爷 什么 意思 ？
手机 如何 网上 订票 手机 如何 网上订票	怎么 样 用 手机 在 网上 订票 怎么样 用手机 在 网上订票
金针 菇 可以 做 什么 菜 ？ 金针菇 可以 做 什么 菜 ？	金针 菇 煮 什么 汤 金针菇 煮 什么 汤
我 比较 喜欢 现在 的 自己 不 太 想 回到 过去 . 是 什么 歌 我 比较 喜欢 现在 的 自己 不太 想 回到过去 . 是 什么 歌	我 想 回到 过去 沉默 着 欢喜 是 什么 歌 我 想 回到过去 沉默 着 欢喜 是 什么 歌
我 的 世界 pe 海绵 怎么 找 我的世界 pe 海绵 怎么 找	我 的 世界 活塞 怎么 合成 我的世界 活塞 怎么 合成
冰 黄瓜 敷脸 好 吗 冰 黄瓜 敷脸 好 吗	黄瓜 敷脸 能 祛痘 吗 黄瓜 敷脸 能 祛痘 吗
关于 申通 快递 送货 关于 申通快递 送货	申通 快递 送货 申通快递 送货
上海 哪家 医院 骨科 最 好 上海 哪家 医院 骨科 最好	上海 哪家 医院 看 骨科 最 好 ？ 上海 哪家 医院 看 骨科 最好 ？
龙泉 驾校 怎么 停 了 龙泉 驾校 怎么 停 了	龙泉 驾校 怎样 ？ 龙泉 驾校 怎样 ？
有 什么 好看 的 魔法 小说 有 什么 好看 的 魔法 小说	有 什么 好看 的 玄幻 小说 吗 有 什么 好看 的 玄幻小说 吗
文章 和 姚笛 是 真的 吗 文章 和 姚笛 是 真的 吗	姚笛 真的 被 文章 干 了 吗 姚笛 真的 被 文章 干 了 吗
这 是 个 什么 牌子 ？ 这 是 个 什么 牌子 ？	焖烧壶 什么 牌子 好 焖烧壶 什么 牌子 好
冬天 到 了 ， 用 什么 护 手 霜 呢 冬天 到 了 ， 用 什么 护手霜 呢	女孩 冬天 用 什么 护 手 霜 好 女孩 冬天 用 什么 护手霜 好
求 一 部 外国 的 科幻 电影 求 一 部 外国 的 科幻电影	求 一 部 外国 科幻 电影 求 一 部 外国 科幻电影
有 女人 缘 是 什么 意思 ？ 有 女人缘 是 什么 意思 ？	小 女人 是 什么 意思 小女人 是 什么 意思
微信 上传 的 图片 怎么 删除 ？ 微信 上传 的 图片 怎么 删除 ？	微信 上传 到 相册 的 照片 怎么 删 不 掉 ！ 微信 上传 到 相册 的 照片 怎么 删不掉 ！
虑 和 替 能 加 什么 偏旁 ？ 虑 和 替 能 加 什么 偏旁 ？	寺 能 加 什么 偏旁 寺 能 加 什么 偏旁
张杰 这 是 什么 发型 ？ 张杰 这 是 什么 发型 ？	张杰 这个 发型 是 什么 。 张杰 这个 发型 是 什么 。
苍蝇 怎么 消灭 苍蝇 怎么 消灭	怎么 消灭 大 苍蝇 怎么 消灭 大 苍蝇
网络 电视 买 什么 牌子 的 好 网络电视 买 什么 牌子 的 好	想 买 液晶 电视 , 但 不 知道 什么 牌子 好 想 买 液晶 电视 , 但 不知道 什么 牌子 好
手 指甲 的 白色 月牙 代表 什么 手指甲 的 白色 月牙 代表 什么	手 指甲 白色 小 月牙 的 地方 是 什么 手指甲 白色 小 月牙 的 地方 是 什么
打 五角 星 的 怎么 读 打 五角星 的 怎么 读	五角星 怎么 打 出来 ？ 五角星 怎么 打 出来 ？
这 发型 叫 什么 名字 这 发型 叫 什么 名字	这些 发型 都 叫 什么 名字 ( 如 下 图 ) 这些 发型 都 叫 什么 名字 ( 如下图 )
晚上 能 吃 苹果 吗 ？ 晚上 能 吃苹果 吗 ？	晚上 可以 吃 苹果 吗 晚上 可以 吃苹果 吗
英雄 联盟 最 低 配置 英雄 联盟 最低配置	玩 英雄 联盟 的 最低 配置 玩 英雄 联盟 的 最低配置
压缩 面膜 用 纯 牛奶 可以 吗 压缩 面膜 用 纯牛奶 可以 吗	纯 牛奶 可以 用 压缩 面膜 做 吗 纯牛奶 可以 用 压缩 面膜 做 吗
帮 我 看 下 水电 安装 价格 对 不 帮 我 看 下 水电安装 价格 对不对	水电 安装 价格 水电安装 价格
没有 收入 证明 怎样 办 信用卡 没有 收入证明 怎样 办 信用卡	没有 收入 证明 ， 如何 办 信用卡 ？ 没有 收入证明 ， 如何 办 信用卡 ？
用 ( 优 ) 组词 ， 填空 用 ( 优 ) 组词 ， 填空	用 ( 亲 ) 组词 填空 。 用 ( 亲 ) 组词 填空 。
血红 蛋白 低 吃 什么 好 血红蛋白 低 吃什么 好	吃 什么 补 血红 蛋白 吃 什么 补 血红蛋白
电信 手机 如何 取消 套餐 电信 手机 如何 取消 套餐	电信 手机 如何 退订 流量 套餐 电信 手机 如何 退订 流量 套餐
丈二和尚 的 歇后语 丈二和尚 的 歇后语	歇后语 丈二和尚 歇后语 丈二和尚
三星 手机 如何 拍 屏幕 照 ？ 三星 手机 如何 拍 屏幕 照 ？	三星 怎么 截 屏幕 图 手机 三星 怎么 截 屏幕 图 手机
汽车 坐垫 什么 牌子 好 ？ 汽车 坐垫 什么 牌子 好 ？	什么 牌子 的 汽车 坐垫 好 什么 牌子 的 汽车 坐垫 好
谁 有 狂三 这 张 高清 的 谁 有 狂三 这 张 高清 的	这 张 高清 图 ， 谁 有 这 张 高清 图 ， 谁 有
今天 是 几九 了 今天 是 几九 了	今天 到 几九 了 今天 到 几九 了
苹果 怎么 改 字体 ？ 已 越狱 苹果 怎么 改 字体 ？ 已 越狱	越狱 苹果 怎么 改 字体 越狱 苹果 怎么 改 字体
最近 有 什么 好看 的 节目 吗 ？ 最近 有 什么 好看 的 节目 吗 ？	最近 有 什么 好看 的 节目 么 ？ 最近 有 什么 好看 的 节目 么 ？
补充 完整 句子 补充 完整 句子	请 把 句子 补充 完整 。 请 把 句子 补充 完整 。
胆 结石 看 什么 科 胆结石 看 什么 科	胆 结石 不 可以 吃 什么 胆结石 不可以 吃 什么
哪 种 奶粉 口味 接近 母乳 哪 种 奶粉 口味 接近 母乳	国产 哪 一 种 奶粉 味道 比较 接近 母乳 国产 哪 一 种 奶粉 味道 比较 接近 母乳
韩语 晚安 怎么 说 韩语 晚安 怎么说	用 韩语 怎么 说 晚安 死猪 用 韩语 怎么 说 晚安 死猪
怎么 开 超级 会员 ， 移动 卡 。 怎么 开 超级 会员 ， 移动 卡 。	移动 怎样 刷 超级 会员 移动 怎样 刷 超级 会员
在 微信 上 如何 增加 粉丝 量 在 微信 上 如何 增加 粉丝 量	怎么 增加 微信 粉丝 怎么 增加 微信 粉丝
张杰 和 谢娜 结婚 了 吗 ？ 张杰 和 谢娜 结婚 了 吗 ？	张杰 和 谢娜 结婚 啦 吗 张杰 和 谢娜 结婚 啦 吗
韩后 的 护肤 品 好 不 韩后 的 护肤品 好不好	韩后 的 护肤 品 谁 用 过 ， 好 不 。 韩后 的 护肤品 谁 用 过 ， 好不好 。
我 是 世界 皮肤 怎么 用 ？ 我 是 世界 皮肤 怎么 用 ？	我 的 世界 手机 皮肤 怎么 用 ， 要 全 过程 我的世界 手机 皮肤 怎么 用 ， 要 全 过程
梦幻 西游 房子 风水 怎么 控制 梦幻西游 房子 风水 怎么 控制	梦幻 西游 房子 风水 怎么 改 梦幻西游 房子 风水 怎么 改
求 一 首 粤语 老歌 求 一 首 粤语 老歌	找 一 首 粤语 老歌 找 一 首 粤语 老歌
这些 人 是 谁 ？ 这些人 是 谁 ？	这个 人 是 谁 ？ 这个人 是 谁 ？
什么 播放 器 可以 缓存 火影 忍者 什么 播放器 可以 缓存 火影忍者	哪个 播放 器 可以 缓存 火影 忍者 哪个 播放器 可以 缓存 火影忍者
实习 日记 会计 实习 日记 会计	会计 实习 日记 会计 实习 日记
什么 是 文房四宝 什么 是 文房四宝	文房四宝 指 什么 ？ 文房四宝 指 什么 ？
谁 可以 帮 我 刷 把 英雄 极 武器 谁 可以 帮 我 刷 把 英雄 极 武器	刷 可以 帮 我 英雄 级 武器 刷 可以 帮 我 英雄 级 武器
怎么 折 爱心 图 怎么 折 爱心 图	爱心 桃 怎么 折 爱心 桃 怎么 折
大 智慧 和 同花顺 哪个 好 用 大智慧 和 同花顺 哪个 好 用	同花顺 和 大 智慧 哪个 好 用 同花顺 和 大智慧 哪个 好 用
此 淘宝 模特 是 谁 ？ 此 淘宝 模特 是 谁 ？	这个 淘宝 的 模特 是 谁 ？ 这个 淘宝 的 模特 是 谁 ？
为什么 女人 就 喜欢 为难 ? 为什么 女人 就 喜欢 为难 ?	为什么 男人 总 喜欢 别 的 女人 为什么 男人 总 喜欢 别 的 女人
有 哪 位 大神 知道 她 是 谁 ？ 有 哪位 大神 知道 她 是 谁 ？	哪 位 大神 谁 知道 她 是 哪位 大神 谁知道 她 是 谁
好 一点 的 电影 好 一点 的 电影	有 哪些 黄 一点 电影 有 哪些 黄 一点 电影
赵 本山 小品 MP4 哪里 能 下载 赵本山小品 MP4 哪里 能 下载	哪里 有 赵 本山 小品 高清 版 下载 哪里 有 赵本山小品 高清 版 下载
还是 不行 日语 怎么 说 还是不行 日语 怎么说	日语 ‘ 为什么 ， 我 不行 怎么 说 日语 ‘ 为什么 ， 我 不行 怎么说
什么 牌子 的 碗 具 最 好 ？ 什么 牌子 的 碗 具 最好 ？	什么 牌子 的 钩机 最 好 用 ？ 什么 牌子 的 钩机 最好 用 ？
怎样 系 鞋带 ？ 怎样 系 鞋带 ？	怎么 系 鞋带 图 怎么 系 鞋带 图
虎口拔牙 是 什么 肖 虎口拔牙 是 什么 肖	什么 苛 虎口拔牙 的 道 里 一样 什么 苛 虎口拔牙 的 道 里 一样
马铃薯 是 吃 它 的 什么 马铃薯 是 吃 它 的 什么	马铃薯 是 什么 呢 马铃薯 是 什么 呢
属 羊 与 什么 属相 相配 属羊 与 什么 属相 相配	属 兔 女 和 什么 属相 相配 属兔 女 和 什么 属相 相配
我 和 哪个 明星 相似 我 和 哪个 明星 相似	我 与 明星 相似 度 我 与 明星 相似 度
类似 于 守护 甜心 的 动漫 类似于 守护甜心 的 动漫	类似 于 《 守护 甜心 》 的 动漫 类似于 《 守护甜心 》 的 动漫
怎么 抢 无线 网速 怎么 抢 无线 网速	怎么 可以 让 无线 网速 更 快 怎么 可以 让 无线 网速 更 快
妈妈 的 奶奶 叫 什么 ？ 妈妈 的 奶奶 叫 什么 ？	妈妈 的 奶奶 我 叫 什么 ？ 妈妈 的 奶奶 我 叫 什么 ？
杭州 明天 天气 怎么 样 ？ 杭州 明天 天气 怎么样 ？	杭州 明天 天气 如何 ？ 杭州 明天 天气 如何 ？
乐视 网 怎么 样 ？ 乐视 网 怎么样 ？	全 视 网 怎么 停 了 全 视 网 怎么 停 了
怎么 知道 对方 有 没 上 微信 怎么 知道 对方 有没有 上 微信	微信 上 怎么 看 别人 是否 在线 微信 上 怎么看 别人 是否 在线
怎样 让 自己 的 台式 机 可以 无线 上网 怎样 让 自己 的 台式机 可以 无线上网	台式 机 能 无线 上网 吗 台式机 能 无线 上网 吗
手机 充值 卡 哪里 有 卖 ? 手机充值卡 哪里 有 卖 ?	手机 充值 卡 哪里 有的 卖 手机充值卡 哪里 有的卖
宅 在 家里 能 做 什么 工作 呢 宅 在家里 能 做什么 工作 呢	什么 工作 可以 在 家里 做 什么 工作 可以 在家里 做
嘴里 发苦 是 什么 原因 ， 嘴里 发苦 是 什么 原因 ，	嘴里 发苦 什么 原因 嘴里 发苦 什么 原因
杭州 哪里 好玩 杭州 哪里 好玩	杭州 有 哪里 好玩 的 杭州 有 哪里 好玩 的
女人 生 孩子 打 一 成语 女人 生 孩子 打一成语	女人 生 孩子 ， 打 一 成语 } 女人 生 孩子 ， 打一成语 }
合肥 是 什么 意思 合肥 是 什么 意思	合肥 话 ， 《 不 顶 龙 是 什么 意思 ？ 》 合肥 话 ， 《 不顶龙 是 什么 意思 ？ 》
求 高干 军婚 小说 求 高干 军婚 小说	求 小说 、 高干 军婚 求 小说 、 高干 军婚
“ 她 是 属于 我 的 ” 用 英语 怎么 说 ！ 要 正确 答案 “ 她 是 属于 我 的 ” 用 英语 怎么说 ！ 要 正确答案	起风 用 英语 怎么 说 。 一 有 正确 答案 就 赞 起风 用 英语 怎么说 。 一 有 正确 答案 就 赞
很 黄 的 日本 动漫 ！ 很 黄 的 日本 动漫 ！	关于 日本 动漫 ， 关于 日本动漫 ，
顶 福利 是 什么 意思 顶 福利 是 什么 意思	福利 是 什么 意思 福利 是 什么 意思
有 没 会 的 成语 有没有 会 的 成语	带 绣 的 成语 有 没 带 绣 的 成语 有没有
鸡 最 喜欢 吃 什么 水果 ？ 鸡 最 喜欢 吃 什么 水果 ？	牛 喜欢 吃 什么 水果 牛 喜欢 吃 什么 水果
摩托 车 的 真空 胎 怎么 补 摩托车 的 真空胎 怎么 补	摩托 车 真空 胎 漏气 怎么 补 摩托车 真空胎 漏气 怎么 补
大 长 脸 适合 什么 发型 啊 大 长脸 适合 什么 发型 啊	大 长 脸 适合 什么 发型 大 长脸 适合 什么 发型
很 高兴 认识 你 。 很高兴认识你 。	大家 好 ！ 很 高兴 认识 大家好 ！ 很高兴 认识 大家
你 在 哪里 开 挖掘 机 啊 你 在 哪里 开 挖掘机 啊	学 挖掘 机 哪里 强 学 挖掘机 哪里 强
在 网上 怎么 赚 钱 。 做 什么 兼职 好 呢 在 网上 怎么 赚钱 。 做 什么 兼职 好 呢	网上 怎么 兼职 赚钱 网上 怎么 兼职 赚钱
什么 虫子 能 吃 什么 虫子 能 吃	什么 虫子 什么 虫子
香港 买 什么 最 划算 ？ 香港 买 什么 最划算 ？	去 香港 买 什么 划算 去 香港 买 什么 划算
如何 打印 图片 ？ 如何 打印 图片 ？	如何 打印 长 图片 如何 打印 长 图片
吃 什么 药 止咳 好 吃 什么 药 止咳 好	什么 能 止咳 ？ 什么 能 止咳 ？
过瘾 是 什么 意思 过瘾 是 什么 意思	不 过瘾 的 意思 是 什么 不过瘾 的 意思 是 什么
怎么 学 粤语 ？ 怎么 学 粤语 ？	粤语 你 叫 什么 怎么 说 粤语 你 叫 什么 怎么说
小 男生 的 那个 部位 什么 样 小男生 的 那个 部位 什么 样	小 男生 的 那个 部位 是 什么 样 小男生 的 那个 部位 是 什么 样
今天 武汉 天气 今天 武汉 天气	武汉 今天 的 天气 。 武汉 今天 的 天气 。
如何 在 手机 上 恢复 微信 聊天 记录 如何 在 手机 上 恢复 微信 聊天记录	微信 重装 文字 聊天 记录 如何 恢复 微信 重装 文字 聊天记录 如何 恢复
哪里 批发 童装 最 便宜 呢 哪里 批发 童装 最 便宜 呢	哪里 童装 批发 便宜 哪里 童装 批发 便宜
怎么 当 城管 怎么 当 城管	怎么 搞 死 城管 怎么 搞 死 城管
什么 运动 减肥 最 有 有效 什么 运动 减肥 最 有 有效	什么 时间 段 做 运动 对 减肥 最 有效 什么 时间 段 做 运动 对 减肥 最有效
户口 本 能 买 火车 票 吗 户口本 能 买 火车票 吗	户口 本 可以 取 火车 票 吗 户口本 可以 取 火车票 吗
被 爆 菊花 是 什么 感觉 被 爆 菊花 是 什么 感觉	捅 菊花 是 什么 感觉 呢 捅 菊花 是 什么 感觉 呢
不要 嘛 用 韩语 怎么 说 不要 嘛 用 韩语 怎么说	韩语 的 请 不要 走 怎么 说 韩语 的 请不要 走 怎么说
下 呼吸 道 感染 是 指 什么 ？ 下呼吸道感染 是 指 什么 ？	猫 呼吸 道 感染 吃 什么 猫 呼吸道感染 吃 什么
求婚 戒指 戴 在 哪 求婚 戒指 戴 在 哪	求婚 戒指 去 哪 打 求婚 戒指 去 哪 打
结婚 证 在 哪里 办 都 可以 吗 结婚证 在哪里 办 都 可以 吗	同 ， 可以 在 哪里 领 结婚 证 ？ 同 ， 可以 在 哪里 领 结婚证 ？
网上 怎么 查 电费 网上 怎么 查 电费	怎么 在 网 上 交 电费 怎么 在 网上 交 电费
求 喝 的 另 一个 音 组词 求 喝 的 另一个 音 组词	来 一个 鹃 的 组词 来 一个 鹃 的 组词
干 海星 能 做 什么 干 海星 能 做 什么	海星 吃 什么 海星 吃 什么
黎明 绝杀 的 老 鸭 是 谁 黎明 绝杀 的 老 鸭 是 谁	黎明 绝杀 中 老 鸭 是 谁 黎明 绝杀 中 老 鸭 是 谁
怎么 在家 上网 赚钱 怎么 在家 上网 赚钱	女 怎么 样 在家 上网 可以 赚钱 女 怎么样 在家 上网 可以 赚钱
怎样 织 毛线 帽子 ？ 怎样 织 毛线 帽子 ？	毛线 帽子 尖 怎么 织 毛线 帽子 尖 怎么 织
湖南 卫视 我们 约会 吧 中间 的 歌曲 是 什么 湖南卫视 我们 约会 吧 中间 的 歌曲 是 什么	我们 约会 吧 成功 歌曲 是 什么 我们 约会 吧 成功 歌曲 是 什么
怎么 用 手机 在 网上 抢 火车 票 怎么 用手机 在 网上 抢 火车票	用 手机 网上 怎么 买 火车 票 用手机 网上 怎么 买 火车票
糯米 块 怎么 煮 好吃 糯米 块 怎么 煮 好吃	糯米 和 肉 怎么 做 好吃 糯米 和 肉 怎么 做 好吃
如何 查询 自己 手机 的 密码 ？ 如何 查询 自己 手机 的 密码 ？	怎么 看 自己 手机 热点 密码 怎么 看 自己 手机 热点 密码
为什么 雨 后 会 出现 彩虹 为什么 雨后 会出现 彩虹	为什么 雨后 彩虹 出现 的 时间 不 太 长 为什么 雨后彩虹 出现 的 时间 不太 长
这 是 什么 软件 ？ ！ 这 是 什么 软件 ？ ！	这 是 什么 跑分 软件 啊 ？ 这 是 什么 跑分 软件 啊 ？
如何 在家 自己 做 生日 蛋糕 上 的 奶油 如何 在家 自己做 生日蛋糕 上 的 奶油	如何 在 家里 制作 蛋糕 上面 的 奶油 如何 在家里 制作 蛋糕 上面 的 奶油
为什么 天空 看 起来 是 蓝色 的 为什么 天空 看起来 是 蓝色 的	那 为什么 天空 是 蓝色 的 呢 那 为什么 天空是蓝色的 呢
发帖 怎么 发 发帖 怎么 发	我 想 发帖 怎么 发 我 想 发帖 怎么 发
什么 时候 是 尾牙 啊 ？ 什么 时候 是 尾牙 啊 ？	什么 是 尾牙 油 什么 是 尾牙 油
有 什么 好看 的 韩国 电视 剧 吗 有 什么 好看 的 韩国 电视剧 吗	有 什么 好看 的 韩国 电视 剧 吗 ？ 有 什么 好看 的 韩国 电视剧 吗 ？
明天 我 依然 爱 你 主题 曲 明天 我依然爱你 主题曲	求 明天 依然 爱 你 主题 曲 ！ 求 明天 依然爱你 主题曲 ！
这 皮带 怎么 系 这 皮带 怎么 系	怎么 穿 皮带 … 怎么 穿 皮带 …
至 高 无 后面 是 什么 至 高 无 后面 是 什么	后面 那 是 什么 ？ 后面 那 是 什么 ？
什么 翅膀 啊 ？ 什么 翅膀 啊 ？	什么 翅膀 什么 翅膀
大自然 的 文字 指 什么 ？ 大自然的文字 指 什么 ？	大自然 的 文字 是 指 什么 大自然的文字 是 指 什么
分 的 另外 一个 读音 怎么 组词 分 的 另外一个 读音 怎么 组词	还有 一个 读音 的 怎么 组词 啊 … 还有一个 读音 的 怎么 组词 啊 …
怎么 领取 支付宝 红包 怎么 领取 支付宝 红包	怎样 领取 支付宝 红包 怎样 领取 支付宝 红包
南都 电池 怎么 样 南都 电池 怎么样	我 的 电池 怎么 了 我 的 电池 怎么 了
《 边 走 爱 》 的 原 唱 是 谁 ？ 《 边走边爱 》 的 原唱 是 谁 ？	他 不 爱 我 原 唱 是 谁 ？ 他 不爱我 原唱 是 谁 ？
现货 原油 操作 怎么 学 ？ 现货 原油 操作 怎么 学 ？	现货 类 的 原油 是 怎么 操作 ？ 现货 类 的 原油 是 怎么 操作 ？
成都 哪里 有 卖 烧烤 用 的 纸 成都 哪里 有 卖 烧烤 用 的 纸	成都 哪里 有 卖 烧烤 刷 成都 哪里 有 卖 烧烤 刷
如何 快速 减肥 ？ 如何 快速 减肥 ？	怎么 快速 减肥 怎么 快速减肥
冬眠 是 什么 意思 ？ 冬眠 是 什么 意思 ？	冬眠 的 意思 是 什么 冬眠 的 意思 是 什么
双 色 球 怎样 杀 号 和 走势 图 ？ 双色球 怎样 杀号 和 走势图 ？	怎样 看 双 色 球 走势 图 怎样 看 双色球 走势图
什么 贴吧 比较 大 ？ 什么 贴吧 比较 大 ？	什么 鱼 的 刺 比较 少 ？ 什么 鱼 的 刺 比较 少 ？
网吧 的 驱动 防火墙 怎样 关闭 ？ 网吧 的 驱动 防火墙 怎样 关闭 ？	网吧 驱动 防火墙 怎么 关闭 网吧 驱动 防火墙 怎么 关闭
谁 是 情歌 王子 谁 是 情歌王子	情歌 王子 是 谁 情歌王子 是 谁
这个 男生 发型 怎么 做 这个 男生 发型 怎么 做	男生 发型 怎么 自己 吹 男生 发型 怎么 自己 吹
美女 也 烦恼 中 插曲 美女也烦恼 中 插曲	美女 的 烦恼 插曲 ( 星 ) 美女的烦恼 插曲 ( 星 )
王俊凯 签名 怎么 写 王俊凯 签名 怎么写	王俊凯 的 签名 怎么 写 王俊凯 的 签名 怎么写
海浪 什么 就 像 海浪 什么 就像	海浪 什么 海浪 什么
正宗 的 酱 猪头 肉 怎么 做 ， 要 最 好吃 做法 ！ 正宗 的 酱 猪头肉 怎么 做 ， 要 最 好吃 做法 ！	怎么 做 才 会 让 猪头 肉 、 鸡肉 好吃 ！ 怎么 做 才会 让 猪头肉 、 鸡肉 好吃 ！
这 是 什么 狗 它 吃 ？ 这 是 什么 狗 它 吃 ？	这 是 什么 ？ 猜 一 这 是 什么 ？ 猜一猜
这 三 个 人 叫 什么 名字 这 三个人 叫 什么 名字	姓吴 的 女 三 个 字 叫 什么 名字 好 姓吴 的 女 三个字 叫 什么 名字 好
什么 是 水 的 玻璃 态 什么 是 水 的 玻璃态	什么 是 玻璃 人 ？ 什么 是 玻璃人 ？
有 什么 方法 能 快速 减肥 呢 有 什么 方法 能 快速减肥 呢	快速 减肥 方法 吃 什么 ？ 快速减肥 方法 吃什么 ？
建筑 图纸 怎么 看 建筑图纸 怎么看	怎样 看懂 建筑 图纸 怎样 看懂 建筑 图纸
火影 和 海贼 王 哪个 好看 火影 和 海贼王 哪个 好看	海贼 王 火影 死神 哪个 最 好看 海贼王 火影 死神 哪个 最 好看
怎么 做 盗号 软件 （ 详解 ） 怎么 做 盗号 软件 （ 详解 ）	怎么 用 易 语言 制作 盗号 软件 啊 怎么 用 易语言 制作 盗号 软件 啊
什么 是 蚂蚁 上 树 ？ 什么 是 蚂蚁上树 ？	什么 是 蚂蚁 上 树 什么 是 蚂蚁上树
有 美女 聊天 吗 ？ 有 美女 聊天 吗 ？	怎么 找 美女 聊天 怎么 找 美女 聊天
多少 天 可以 流产 多少 天 可以 流产	怎样 可以 流产 。 怎样 可以 流产 。
什么 是 宽带 隙 什么 是 宽带隙	什么 是 云 宽带 ？ 什么 是 云 宽带 ？
剑指 苍穹 是 什么 意思 剑指 苍穹 是 什么 意思	苍穹 的 意思 是 什么 苍穹 的 意思 是 什么
跑步 穿 什么 鞋 ？ 跑步 穿 什么 鞋 ？	跑步 前 吃 什么 好 跑步 前 吃 什么 好
晶弘 冰箱 怎么 样 晶弘 冰箱 怎么样	晶弘 冰箱 怎么 晶弘 冰箱 怎么
我 喜欢 吃 的 东西 是 ？ 我 喜欢 吃 的 东西 是 ？	为什么 我 喜欢 咬 东西 ？ 为什么 我 喜欢 咬 东西 ？
坐 月子 可以 吃 青菜 吗 坐月子 可以 吃 青菜 吗	坐 月子 可以 吃 青菜 吗 ？ 坐月子 可以 吃 青菜 吗 ？
全国 各省 省委 书记 和 省长 全国各省 省委书记 和 省长	统计 现任 各省 省委 书记 和 省长 是 谁 统计 现任 各省 省委书记 和 省长 是 谁
求 一 部 关于 十二 生肖 的 动画 片 求 一 部 关于 十二生肖 的 动画片	求 一 部 十二 生肖 的 动画 片 求 一 部 十二生肖 的 动画片
知己 是 什么 意思 ？ 知己 是 什么 意思 ？	知己 是 什么 意思 知己 是 什么 意思
全部 紫色 的 是 什么 花 图片 全部 紫色 的 是 什么 花 图片	图片 上 紫色 的 花 叫 什么 图片 上 紫色 的 花 叫 什么
爸爸 去 哪儿 会 拍 第三 季 吗 ？ 爸爸 去哪儿 会 拍 第三季 吗 ？	爸爸 去 哪儿 第三 季 会 有 谁 爸爸 去哪儿 第三季 会 有 谁
伴随 是 什么 意思 伴随 是 什么 意思	伴随 是 什么 意思 ？ 伴随 是 什么 意思 ？
六一 儿童 节 送 孩子 什么 礼物 ？ 六一 儿童节 送 孩子 什么 礼物 ？	六一 儿童 节 该 送 孩子 什么 礼物 六一 儿童节 该 送 孩子 什么 礼物
什么 是 有钱 人 啊 什么 是 有钱人 啊	有 钱 人 都 吃 什么 有钱人 都 吃什么
妈妈 是 怎么 堕落 妈妈 是 怎么 堕落	妈妈 是 怎样 堕落 妈妈 是 怎样 堕落
长江 后浪 推 前浪 ， 下 一句 是 什么 ？ 长江后浪推前浪 ， 下 一句 是 什么 ？	长江 后浪 推 前浪 ？ 下 一句 是 什么 长江后浪推前浪 ？ 下 一句 是 什么
高粱 红 了 如 什么 高粱红了 如 什么	什么 的 高粱 什么 的 高粱
小 薏米 和 大 有 什么 区别 小 薏米 和 大 有 什么 区别	薏仁 粉 和 薏米 有 什么 区别 薏仁粉 和 薏米粉 有 什么 区别
恢复 的 反义词 是 什么 恢复 的 反义词 是 什么	恢复 的 反义词 是 什么 ？ 恢复 的 反义词 是 什么 ？
有 没 在家 办公 的 工作 有没有 在家办公 的 工作	远程 办公 / 在家 工作 的 优 缺点 远程办公 / 在家 工作 的 优缺点
怎么 在 手机 上 申请 旺旺 号 怎么 在 手机 上 申请 旺旺 号	在 电脑 上 申请 的 旺旺 号 手机 怎么 不 能 登 在 电脑 上 申请 的 旺旺 号 手机 怎么 不能 登
现在 淘宝 上 什么 最 好 卖 现在 淘宝 上 什么 最好 卖	现在 淘宝 上 什么 最 好 卖 ？ 现在 淘宝 上 什么 最好 卖 ？
表格 怎么 填 ？ 表格 怎么 填 ？	表格 怎么 做 表格 怎么 做
推荐 好看 古代 小说 推荐 好看 古代小说	推荐 好看 的 古代 小说 推荐 好看 的 古代 小说
我 的 世界 皮肤 站 怎么 用 ？ 我的世界 皮肤 站 怎么 用 ？	我 的 世界 怎么 搞 皮肤 ？ 我的世界 怎么 搞 皮肤 ？
考试 怎么 考 高分 ？ 考试 怎么 考 高分 ？	考试 如何 考 高分 考试 如何 考 高分
想 自己 开店 不 知道 做 什么 比较 好 想 自己 开店 不知道 做什么 比较好	我 想 自己 开店 ， 就 是 不 知道 做 什么 比较 好 我 想 自己 开店 ， 就是 不知道 做什么 比较好
这 配置 可以 玩 蜘蛛 侠 ： 破碎 维度 吗 这 配置 可以 玩 蜘蛛侠 ： 破碎 维度 吗	这 配置 能 玩 蜘蛛 侠 破碎 维度 吗 ？ 这 配置 能 玩 蜘蛛侠 破碎 维度 吗 ？
手机 版 我 的 世界 有 素材 包 吗 手机 版 我的世界 有 素材 包 吗	手机 版 我 的 世界 素材 包 去 哪里 下载 手机 版 我的世界 素材 包 去哪里 下载
朋友 心情 不好 ， 怎么 安慰 他 ？ 朋友 心情 不好 ， 怎么 安慰 他 ？	怎么 安慰 心情 不好 的 朋友 怎么 安慰 心情不好 的 朋友
作文 爸爸 妈妈 我 想 对 你 说 作文 爸爸 妈妈 我 想 对 你 说	爸爸 妈妈 我 想 对 你 说 作文 爸爸 妈妈 我 想 对 你 说 作文
梦见 鱼 吃 人 是 什么 意思 梦见 鱼 吃 人 是 什么 意思	梦见 狗 舔 我 脸 是 什么 意思 啊 梦见 狗 舔 我 脸 是 什么 意思 啊
世界杯 谁 进球 最 多 啊 ？ 世界杯 谁 进球 最多 啊 ？	这 届 世界杯 谁 进球 最 多 啊 ? 这 届 世界杯 谁 进球 最多 啊 ?
酒 喝 多 了 有 什么 坏处 ？ 酒 喝 多 了 有 什么 坏处 ？	这样 有 什么 坏处 呢 ？ 这样 有 什么 坏处 呢 ？
红米 手机 好 不 ？ 红米 手机 好不好 ？	红米 手机 好 不 用 ？ 红米 手机 好不好 用 ？
这 是 什么 品种 的 兰花 啊 这 是 什么 品种 的 兰花 啊	这 是 什么 品种 的 兰花 ？ 这 是 什么 品种 的 兰花 ？
这 是 什么 东西 ？ 这 是 什么 东西 ？	这 是 什么 东西 ？ 果果 这 是 什么 东西 ？ 果果
我 与 情敌 我 与 情敌	谁 是 我 的 情敌 谁 是 我 的 情敌
干 屁眼 女人 爽 吗 干 屁眼 女人 爽 吗	女人 的 屁眼 能 插 吗 女人 的 屁眼 能 插 吗
求 一些 基督教 的 歌曲 求 一些 基督教 的 歌曲	还是 爱 你 基督 教 歌曲 还是 爱 你 基督教 歌曲
吃 黑 巧克力 会 发胖 吗 ？ 吃 黑巧克力 会 发胖 吗 ？	很 饿 的 时候 吃 巧克力 会 发胖 吗 ？ 很 饿 的 时候 吃巧克力 会 发胖 吗 ？
如何 与 长辈 聊天 如何 与 长辈 聊天	如何 跟 长辈 聊天 如何 跟 长辈 聊天
江南 四 大 才子 是 谁 江南四大才子 是 谁	江南 四 大 才子 都 是 谁 江南四大才子 都 是 谁
什么 鱼 吃 河蚌 什么 鱼 吃 河蚌	河蚌 吃 什么 ？ 河蚌 吃 什么 ？
帅哥 ， 美女 教 一下 帅哥 ， 美女 教 一下	猜 一下 美女 和 帅哥 吧 ！ 猜一下 美女 和 帅哥 吧 ！
温故 而 知 新 的 是 什么 意思 温故而知新 的 新 是 什么 意思	温故 而 知 新 的 而是 什么 意思 温故而知新 的 而是 什么 意思
今天 财神 在 哪 个 方位 今天 财神 在 哪个 方位	今天 财神 方位 今天 财神 方位
这个 表情 是 什么 系列 的 ？ 这个 表情 是 什么 系列 的 ？	这个 是 什么 表情 系列 ? 这个 是 什么 表情 系列 ?
关于 中学生 女 发型 。 关于 中学生 女 发型 。	中学生 的 发型 中学生 的 发型
猜 这个 女 毒贩 穿 什么 裤子 啊 猜 这个 女 毒贩 穿什么 裤子 啊	大家 猜 这个 女 毒贩 穿 什么 裤子 啊 大家 猜 这个 女 毒贩 穿什么 裤子 啊
北京 最近 天气 怎么 样 北京 最近 天气 怎么样	北京 最近 天气 如何 北京 最近 天气 如何
郑州 服装 批发 市场 在 哪 郑州 服装 批发市场 在 哪	郑州 都 有 哪些 服装 批发 市场 郑州 都 有 哪些 服装 批发市场
泰山 好玩 吗 ？ 泰山 好玩 吗 ？	泰山 有 什么 好玩 的 吗 ？ 泰山 有 什么 好玩 的 吗 ？
到 这里 硬盘 坏道 怎么 修复 到 这里 硬盘坏道 怎么 修复	如何 修复 硬盘 坏道 如何 修复 硬盘坏道
医 馆 笑 传 那个 播放 器 可以 看 医 馆 笑 传 那个 播放器 可以 看	什么 播放 器 能 看 医 馆 笑 传 。 什么 播放器 能 看 医 馆 笑 传 。
井盖 为什么 是 圆 的 呢 ？ 井盖 为什么 是 圆 的 呢 ？	为什么 下 隧 水道 的 井盖 是 圆 为什么 下 隧 水道 的 井盖 是 圆
人 艰 不 拆 是 什么 意思 人 艰 不 拆 是 什么 意思	人 艰 不 拆 是 什么 意思 ？ 人 艰 不 拆 是 什么 意思 ？
海岛 奇兵 这个 岛 怎么 打 ？ 海岛奇兵 这个 岛 怎么 打 ？	怎么 打 ？ 求 海岛 奇兵 怎么 打 ？ 求 海岛奇兵
张郃 的 妻子 是 谁 张郃 的 妻子 是 谁	杨绛 是 谁 的 妻子 ？ 杨绛 是 谁 的 妻子 ？
欲钱 看 最 可 爰 的 人 是 什么 生肖 欲钱 看 最 可 爰 的 人 是 什么 生肖	人 已 去 来 悲 如何 是 什么 生肖 人 已 去 来 悲 如何 是 什么 生肖
朦胧 的 意思 是 什么 朦胧 的 意思 是 什么	朦胧 的 爱 什么 意思 ？ 朦胧的爱 什么 意思 ？
帮忙 看 下 这 是 什么 狗 。 帮忙 看 下 这 是 什么 狗 。	大家 帮忙 看 下 这个 是 什么 玉 ？ 大家帮忙 看 下 这个 是 什么 玉 ？
奥特曼 厉害 吗 ？ 奥特曼 厉害 吗 ？	奥特曼 厉害 吗 奥特曼 厉害 吗
这种 字体 的 人 怎么 样 这种 字体 的 人 怎么样	这种 字体 是 什么 ？ 这种 字体 是 什么 ？
你 喜欢 的 人 名字 是 多少 个 字 你 喜欢 的 人 名字 是 多少 个 字	你 最 喜欢 的 名字 是 ？ 你 最 喜欢 的 名字 是 ？
杨 汊 湖 附近 哪里 有 联通 营业 厅 ？ 杨汊湖 附近 哪里 有 联通 营业厅 ？	附近 哪里 有 联通 营业 厅 附近 哪里 有 联通 营业厅
梦见 吃 鸡蛋 是 什么 意思 梦见 吃鸡蛋 是 什么 意思	梦见 鸡 和 鸡蛋 是 什么 意思 梦见 鸡 和 鸡蛋 是 什么 意思
爱情 公寓 里 胡一菲 的 手机 铃声 是 什么 ？ 爱情公寓 里 胡一菲 的 手机铃声 是 什么 ？	爱情 公寓 中 胡一菲 的 手机 铃声 是 什么 爱情公寓 中 胡一菲 的 手机铃声 是 什么
在 侠盗 飞车 怎么 挑 飞机 在 侠盗飞车 怎么 挑 飞机	侠盗 飞车 的 飞机 怎么 开 ？ 侠盗飞车 的 飞机 怎么 开 ？
什么 兔子 最 好 养 什么 兔子 最 好 养	我 的 兔子 叫 什么 最 好 ？ 我 的 兔子 叫 什么 最好 ？
良 什么 美景 良 什么 美景	一 什么 美景 ？ 一 什么 美景 ？
小 学生 爱 什么 ？ 小学生 爱 什么 ？	小学生 学 什么 好 ？ 小学生 学 什么 好 ？
炒 鸡蛋 怎么 做 女 嫩 又 好吃 炒鸡蛋 怎么 做 女 嫩 又 好吃	炒 鸡蛋 怎么 做 好吃 炒鸡蛋 怎么 做 好吃
一 打开 浏览 器 就 这样 一 打开 浏览器 就这样	我 不管 打开 什么 浏览 器 ， 都会 这样 我 不管 打开 什么 浏览器 ， 都会 这样
生肖 虎 和 兔 相 冲 么 生肖 虎 和 兔 相冲 么	生肖 兔 和 马 相 冲 吗 。 生肖 兔 和 马 相冲 吗 。
想 应聘 淘宝 客服 怎么 这么 难 想 应聘 淘宝 客服 怎么 这么难	怎么 应聘 淘宝 云 客服 怎么 应聘 淘宝 云 客服
吃 什么 药 男人 棒子 就 小 吃 什么 药 男人 棒子 就 小	男人 的 大 棒子 头 什么 时候 出来 男人 的 大 棒子 头 什么 时候 出来
世界 上 什么 是 最 痛苦 的 事 世界上 什么 是 最 痛苦 的 事	世界 上 最 痛苦 的 事 是 什么 世界上 最 痛苦 的 事 是 什么
骨头 汤 怎么 做 有 营养 骨头汤 怎么 做 有 营养	骨头 汤 怎么 熬 有 营养 骨头汤 怎么 熬 有 营养
鳄鱼 龟 吃 什么 好 呢 鳄鱼龟 吃 什么 好 呢	小 鳄鱼 吃 什么 ？ 小 鳄鱼 吃 什么 ？
表白 有 什么 用 ？ 表白 有 什么 用 ？	什么 时候 表白 好 ？ 什么 时候 表白 好 ？
空调 不 制冷 ， 是 什么 原因 ？ 空调 不 制冷 ， 是 什么 原因 ？	空调 不 制冷 都 是 什么 原因 空调 不 制冷 都是 什么 原因
为什么 有 的 智能 手机 没有 蓝牙 为什么 有 的 智能手机 没有 蓝牙	为什么 智能 手机 没有 蓝牙 ？ 为什么 智能手机 没有 蓝牙 ？
求 这 张 情侣 图片 的 另 一 ？ 求 这 张 情侣 图片 的 另 一 ？	求 这 张 情侣 图片 的 另 一 求 这 张 情侣 图片 的 另 一
世界 上 最 贵 的 烟 是 什么 世界上 最贵 的 烟 是 什么	世界 上 最 贵 的 菜 是 什么 ？ 世界上 最贵 的 菜 是 什么 ？
衡水 中学 是 哪个 省 衡水中学 是 哪个 省	衡水 中学 贴吧 衡水中学 贴吧
挖掘 机 技术 哪家 强 啊 挖掘机 技术 哪家 强 啊	挖掘 机 技术 哪家 强 挖掘机 技术 哪家 强
形容 帮助 别人 的 成语 。 形容 帮助 别人 的 成语 。	形容 不 帮助 别人 的 成语 形容 不 帮助 别人 的 成语
鱼竿 什么 牌子 好 鱼竿 什么 牌子 好	鱼竿 矶竿 什么 牌子 好 鱼竿 矶竿 什么 牌子 好
本 命 年 送 什么 本命年 送 什么	本 命 年 带 什么 好 ？ 本命年 带 什么 好 ？
余额 宝 怎么 了 余额宝 怎么 了	余额 宝 怎么 始 啊 余额宝 怎么 始 啊
这 叫 什么 高跟 鞋 这 叫 什么 高跟鞋	这种 高跟 鞋 叫 什么 呀 这种 高跟鞋 叫 什么 呀
聚集 的 近义词 有 什么 聚集 的 近义词 有 什么	聚集 的 近义词 是 什么 ？ 聚集 的 近义词 是 什么 ？
怎么 登陆 网 宝 怎么 登陆 网 宝	怎样 登陆 铺铺旺 怎样 登陆 铺铺旺
请 用 一 句 话 证明 你 很 穷 请 用 一句话 证明 你 很 穷	用 一 句 内涵 的 话 证明 你 穷 用 一句 内涵 的 话 证明 你 穷
我 左手 手指 发麻 是 什么 原因 造成 的 我 左手 手指 发麻 是 什么 原因 造成 的	左手 手指 发麻 而且 带有 阵痛 是 什么 原因 左手 手指 发麻 而且 带有 阵痛 是 什么 原因
做 什么 运动 瘦腿 快 做 什么 运动 瘦腿 快	什么 运动 可以 瘦腿 什么 运动 可以 瘦腿
什么 修改 器 能 天天 酷跑 什么 修改器 能 修改 天天 酷跑	什么 修改 器 可以 天天 酷跑 什么 修改器 可以修改 天天 酷跑
关于 马 的 文学 作品 关于 马 的 文学作品	有 这些 文学 作品 的 有 这些 文学作品 的
今年 情人 节 有 什么 电影 今年 情人节 有 什么 电影	2015 年 有 什么 电影 七夕 情人 节 上映 2015 年 有 什么 电影 七夕情人节 上映
雪 的 寓意 是 什么 ？ 雪 的 寓意 是 什么 ？	一凡 是 有 什么 寓意 一凡 是 有 什么 寓意
都 有 哪些 运动 可以 减 肚子 啊 都 有 哪些 运动 可以 减 肚子 啊	什么 样 的 运动 可以 瘦 肚子 啊 、 什么 样 的 运动 可以 瘦 肚子 啊 、
现在 还 有 人 相信 爱情 吗 现在 还有 人 相信爱情 吗	现在 还 能 相信 爱情 吗 ？ 现在 还能 相信爱情 吗 ？
有 钱 ， 任性 什么 意思 有钱 ， 任性 什么 意思	有 钱 就 任性 什么 意思 有钱 就 任性 什么 意思
手机 话费 可以 网上 买 东西 吗 手机 话费 可以 网上 买东西 吗	手机 话费 能 网上 买 东西 吗 ？ 手机 话费 能 网上 买东西 吗 ？
图片 中 的 是 什么 果子 ？ 图片 中 的 是 什么 果子 ？	图片 上 是 什么 果子 图片 上 是 什么 果子
什么 面膜 最 好 用 ？ 什么 面膜 最好 用 ？	什么 时候 贴 面膜 最 好 ！ ？ 什么 时候 贴 面膜 最好 ！ ？
海南岛 是 我国 的 第 几 大岛 海南岛 是 我国 的 第 几 大岛	海南岛 是 我国 的 第 几 大岛 ？ 【 海南岛 是 我国 的 第 几 大岛 ？ 【
天天 酷跑 抽奖 有 什么 技巧 吗 天天 酷跑 抽奖 有 什么 技巧 吗	天天 酷跑 抽奖 技巧 是 什么 ？ 天天 酷跑 抽奖 技巧 是 什么 ？
地瓜 是 什么 地瓜 是 什么	烤 地瓜 是 什么 ？ 烤地瓜 是 什么 ？
求 爱情 公寓 小说 求 爱情公寓 小说	你 有 爱情 公寓 的 小说 吗 ？ 你 有 爱情公寓 的 小说 吗 ？
我 的 世界 怎么 锁 箱子 ？ 我的世界 怎么 锁 箱子 ？	我 的 世界 怎么 做 箱子 我的世界 怎么 做 箱子
什么 动物 最 好 养 什么 动物 最 好 养	最 好 养 的 小 动物 是 什么 ？ 最 好 养 的 小动物 是 什么 ？
网上 怎么 买 火车 票 ？ 安全 吗 网上 怎么 买 火车票 ？ 安全 吗	去 哪儿 网 上 买 火车 票 安全 吗 ？ 去哪儿 网 上 买 火车票 安全 吗 ？
用 什么 中医 可以 减肥 用 什么 中医 可以 减肥	中医 可以 减肥 吗 中医 可以 减肥 吗
香格里拉 的 少数 民族 有 哪些 香格里拉 的 少数民族 有 哪些	少数 民族 的 语言 有 哪些 少数民族 的 语言 有 哪些
求 小说 我 的 贴身 校花 求 小说 我 的 贴身 校花	求 小说 ( 我 的 贴身 校花 ) 求 小说 ( 我 的 贴身 校花 )
怎样 可以 见 到 李易峰 怎样 可以 见到 李易峰	如果 见 到 了 李易峰 ， 你 会 怎么 样 ？ 如果 见到 了 李易峰 ， 你 会 怎么样 ？
修 手表 怎么 修 手表 怎么	媞 芮 手表 怎么 样 ？ 媞芮 手表 怎么样 ？
为什么 背后 会长 痘痘 ? 为什么 背后 会长 痘痘 ?	背后 长 痘痘 腰 为什么 会 痛 背后 长 痘痘 腰 为什么 会 痛
请问 这个 女优 叫 啥 请问 这个 女优 叫 啥	请问 这个 女优 是 谁 请问 这个 女优 是 谁
这 句 话 怎么 翻译 ？ 这句话 怎么 翻译 ？	这 句 话 ， 怎么 翻译 ？ 这句话 ， 怎么 翻译 ？
求 蓝 男色 全部 资源 求 蓝 男色 全部 资源	求 蓝 男色 资源 。 求 蓝 男色 资源 。
想 自己 开店 , 做 什么 比较 好 ? 想 自己 开店 , 做什么 比较好 ?	想 自己 开店 不 知道 做 什么 比较 好 想 自己 开店 不知道 做什么 比较好
沿着 用 英语 怎么 说 ， 快点 沿着 用 英语 怎么说 ， 快点	快点 ， 快 来 用 英语 怎么 说 快点 ， 快 来 用 英语 怎么说
篮球 火 第二 部 什么 时候 出 篮球火 第二部 什么 时候 出	篮球 火 第 2 部 什么 时候 出 篮球火 第 2 部 什么 时候 出
为什么 我 不 能 发帖 ? 为什么 我 不能 发帖 ?	我 为什么 总是 不 能 发帖 我 为什么 总是 不能 发帖
你 看见 过 我 的 小熊 吗 你 看见 过 我 的 小熊 吗	你 看见 了 我 的 小熊 吗 你 看见了 我 的 小熊 了 吗
知识 产权 保护 知识产权保护	保护 知识 产权 保护 知识产权
我 姓 肖 ， 怎么 取 女儿 的 名字 我 姓 肖 ， 怎么 取 女儿 的 名字	我 想 给 女儿 起 名字 ， 姓 邓 我 想 给 女儿 起 名字 ， 姓 邓
长沙 和 武汉 哪个 大 长沙 和 武汉 哪个 大	从 武汉 到 长沙 从 武汉 到 长沙
去 泰国 旅游 买 什么 去 泰国 旅游 买 什么	泰国 旅游 穿 什么 泰国旅游 穿 什么
什么 品牌 指甲 油 好 什么 品牌 指甲油 好	指甲 油 什么 品牌 好 指甲油 什么 品牌 好
光速 和 声速 那个 快 光速 和 声速 那个 快	声速 和 光速 哪个 快 声速 和 光速 哪个 快
可爱 的 可是 什么 意思 ？ 可爱 的 可是 什么 意思 ？	和 气 可爱 是 什么 意思 和 气 可爱 是 什么 意思
赛尔号 经验 卡 怎么 用 ？ 赛尔号 经验 卡 怎么 用 ？	赛尔号 怎么 刷 经验 ？ 赛尔号 怎么 刷 经验 ？
请 各位 帮忙 找 一 款 游戏 请 各位 帮忙 找 一 款 游戏	帮忙 找 一 款 游戏 ！ 帮忙 找 一 款 游戏 ！
燃眉之急 的 急 是 什么 意思 燃眉之急 的 急 是 什么 意思	燃眉之急 的 眉 是 什么 意思 燃眉之急 的 眉 是 什么 意思
冬天 有 什么 水果 冬天 有 什么 水果	冬天 吃 什么 水果 好 ？ 冬天 吃什么 水果 好 ？
哪些 不 是 垃圾 食品 哪些 不是 垃圾 食品	垃圾 食品 有 哪些 垃圾 食品 有 哪些
天猫 和 淘宝 哪个 好 天猫 和 淘宝 哪个 好	淘宝 和 天猫 哪个 好 淘宝 和 天猫 哪个 好
处女 膜 破 的 时候 都 会 痛 吗 处女膜 破 的 时候 都会 痛 吗	我 的 处女 膜 破 了 吗 我 的 处女膜 破 了 吗
什么 样 的 发型 最 是 简单 ？ 什么 样 的 发型 最 是 简单 ？	什么 样 的 发型 最 适合 年轻 幼儿 园 老师 什么 样 的 发型 最 适合 年轻 幼儿园 老师
石家庄 科技 工程 职业 学院 怎么 样 ？ 石家庄 科技 工程 职业 学院 怎么样 ？	石家庄 科技 工程 职业 学院 怎么 样 石家庄 科技 工程 职业 学院 怎么样
如何 制作 游戏 ？ 如何 制作 游戏 ？	游戏 是 怎么 制作 出来 的 ！ 游戏 是 怎么 制作 出来 的 ！
《 乡村 爱情 故事 》 《 乡村爱情 故事 》	乡村 爱情 故事 哈哈 乡村爱情 故事 哈哈
这个 是 什么 牌子 的 香水 这个 是 什么 牌子 的 香水	什么 牌子 香水 好 什么 牌子 香水 好
神探 狄仁杰 第 五 部 什么 时候 出来 ？ 神探狄仁杰 第五部 什么 时候 出来 ？	神探 狄仁杰 第 五 部 什么 时候 开始 神探狄仁杰 第五部 什么 时候 开始
你 大爷 的 ， 就是 对 不 。 你 大爷 的 ， 就是 对不对 。	你 大爷 ！ 你 大爷 ！
请问 这 是 哪 部 动漫 的 请问 这 是 哪 部 动漫 的	请问 这 是 哪 部 动漫 的 ？ 请问 这 是 哪 部 动漫 的 ？
用 挂起 造句 比喻 句 用 挂起 造句 比喻句	冰 这个 词 用 来 造句 比喻 句 冰 这个词 用来 造句 比喻句
属 羊 的 女 名人 有 哪些 属羊 的 女 名人 有 哪些	姓 佘 冼 的 名人 姓 佘 冼 的 名人
我 的 世界 修改 器 怎么 下 我的世界 修改器 怎么 下	我 的 世界 修改 器 怎么 用 ？ 我的世界 修改器 怎么 用 ？
挂 烫 机 那个 牌子 好 挂烫机 那个 牌子 好	挂 烫 机 哪个 牌子 差 挂烫机 哪个 牌子 差
关于 有 理 数 的 分类 关于 有理数 的 分类	有 理 数 的 分类 有理数 的 分类
有 在家 做 手工 活 的 吗 有 在家 做 手工活 的 活 吗	可 在家 做 的 手工 可 在家 做 的 手工
我 的 世界 如何 进 地狱 ？ 我的世界 如何 进 地狱 ？	我 的 世界 地狱 门 怎么 做 我的世界 地狱门 怎么 做
怎样 办理 《 流动 人口 婚育 证明 》 怎样 办理 《 流动人口 婚育证明 》	流动 人口 婚育 证明 怎么 办理 ? 流动人口 婚育证明 怎么 办理 ?
动画 片 和 熊猫 有关 的 动画片 和 熊猫 有关 的	有 关于 熊猫 的 动画 片 有 关于 熊猫 的 动画片
梦到 偷 人家 东西 梦到 偷 人家 东西	梦到 跟 佛有关 的 东西 梦到 跟佛有关 的 东西
为什么 蜗牛 雨天 会 出来 ？ 为什么 蜗牛 雨天 会 出来 ？	蜗牛 为什么 下雨 天才 出来 蜗牛 为什么 下雨 天才 出来
这 裤子 是 什么 品牌 的 这 裤子 是 什么 品牌 的	什么 品牌 的 裤子 好 什么 品牌 的 裤子 好
我 想 找 一个 男 朋友 ， 我 想 找 一个男朋友 ，	找 一个 比 自己 小 的 男 朋友 好 吗 找一个 比 自己 小 的 男朋友 好 吗
青 加 什么 偏旁 青 加 什么 偏旁	青 加 偏旁 是 什么 字 青 加 偏旁 是 什么 字
文章 和 姚笛 演 过 什么 电视 剧 文章 和 姚笛 演 过 什么 电视剧	文章 姚笛 一起 演 过 什么 电视 剧 文章 姚笛 一起 演 过 什么 电视剧
我 的 世界 挖 东西 我的世界 挖 东西	我 的 世界 种 东西 是 什么 土 我的世界 种 东西 的 是 什么 土
什么 是 一体 机 啊 什么 是 一体机 啊	什么 一体 机 好 ？ 什么 一体机 好 ？
说 你 很 迷人 什么 意思 说 你 很 迷人 什么 意思	洵丽 迷人 是 什么 意思 洵丽 迷人 是 什么 意思
新房 装修 后 多久 可以 入住 新房 装修 后 多久 可以 入住	新房 装修 后 多久 可以 入住 ？ 新房 装修 后 多久 可以 入住 ？
怎么 才 能 删除 网易 论坛 的 帖子 呢 ？ 怎么 才能 删除 网易 论坛 的 帖子 呢 ？	怎么 删除 网易 论坛 帖子 ？ 怎么 删除 网易 论坛帖子 ？
你们 说 这 是 什么 颜色 你们 说 这 是 什么 颜色	颜色 是 什么 颜色 是 什么
加油 用 韩语 怎么 说 ？ 加油 用 韩语 怎么说 ？	韩语 加油 怎么 说 韩语 加油 怎么说
领 字 的 形旁 和 声旁 是 什么 领 字 的 形旁 和 声旁 是 什么	这些 的 形旁 和声 旁 各 是 什么 这些 的 形旁 和声 旁 各 是 什么
粱 用 是 哪 部 小说 的 主角 粱 用 是 哪 部 小说 的 主角	叶凡 是 哪 部 小说 主角 叶凡 是 哪 部 小说 主角
筋 疙瘩 是 什么 筋 疙瘩 是 什么	风 疙瘩 吃 什么 药 风疙瘩 吃 什么 药
为什么 我 的 胸 很 大 ？ 为什么 我 的 胸 很大 ？	我 的 胸 很 大 怎么办 我 的 胸 很大 怎么办
怎么 下载 这个 短片 ？ 怎么 下载 这个 短片 ？	怎么 下载 《 我们 》 短片 啊 ？ 怎么 下载 《 我们 》 短片 啊 ？
与 字 加 两笔 等于 什么 与 字 加 两笔 等于 什么	口 字 加 两笔 都 有 什么 ， 比如 ： “ ” 要求 50 个 以上 口 字 加 两笔 都 有 什么 ， 比如 ： “ ” 要求 50 个 以上
有 没 要 电子烟 的 有没有 要 电子烟 的	有 没 要 电子烟 的 啊 有没有 要 电子烟 的 啊
怎么 能 看 出来 生 男生 女 怎么 能 看 出来 生 男生 女	怎样 算 生 男生 女 呢 怎样 算 生 男生 女 呢
星尘 传说 练 哪个 职业 好 星尘传说 练 哪个 职业 好	星尘 传说 哪个 职业 升级 快 星尘传说 哪个 职业 升级 快
微信 平台 怎么 建立 微信 平台 怎么 建立	如何 建立 微信 平台 如何 建立 微信 平台
大家 对 日本 人 日语 怎么 看 大家 对 日本人 日语 怎么看	日本 用 日语 怎么 写 日本 用 日语 怎么写
世界 上 最 小 的 鸟 是 什么 世界上 最小 的 鸟 是 什么	世界 最 小 的 人 叫 什么 世界 最小 的 人 叫 什么
怎样 让 自己 的 屁股 变 小 ！ 怎样 让 自己 的 屁股 变 小 ！	怎样 使 自己 的 大腿 和 屁股 变 小 怎样 使 自己 的 大腿 和 屁股 变 小
皮卡 堂 过家家 送 号 皮卡堂 过家家 送 号	皮卡 堂 过家家 卖 号 皮卡堂 过家家 卖 号
我 的 世界 为什么 没有 鸡 ？ 我的世界 为什么 没有 鸡 ？	我 的 世界 怎么 没有 鸡 我的世界 怎么 没有 鸡
